a ac at ad co et eu in id mi of ut hac dis nam leo nec per sed est dui cum sit non vel sem mus diam eget amet cras arcu erat nibh elit odio enim duis ante orci eros quam nisl nisi quis nunc urna fames diego felis magna etiam lacus donec class curae dolor morbi fusce augue velit vitae lorem massa bytes neque proin nulla metus netus words ipsum risus porta justo purus aenean luccas magnis libero sapien taciti platea sociis aptent dictum semper congue ligula mauris nullam mollis primis ornare montes lectus auctor tellus mattis tempor varius litora tempus luctus cursus turpis nostra tortor rutrum blandit lacinia feugiat dapibus eduardo iaculis cubilia egestas sodales laoreet integer aliquam gravida commodo conubia aliquet rhoncus euismod natoque pretium vivamus potenti posuere viverra quisque maecenas habitant placerat bibendum eleifend facilisi accumsan faucibus praesent vehicula inceptos nascetur sagittis pharetra senectus ultrices dictumst interdum lobortis molestie pulvinar suscipit sociosqu volutpat torquent facilisis himenaeos generated malesuada habitasse imperdiet hendrerit fringilla penatibus convallis dignissim venenatis tincidunt consequat elementum ridiculus curabitur ultricies phasellus fermentum tristique porttitor vulputate adipiscing paragraphs parturient vestibulum attincidunt ullamcorper condimentum consectetur scelerisque suspendisse eduardofusce sollicitudin pellentesque
﻿A contrario sensu: Em sentido contrário. Argumento de interpretação que considera válido ou permitido o contrário do que tiver sido proibido ou limitado.
A digito cognoscitur leo: Pelo dedo se conhece o leão.
A facto ad jus non datur consequentia: Não se dá conseqüência do fato para o direito.
A fortiori: Por mais forte razão, por maior razão. Quando um dispositivo legal, por razões que se acrescem as nele previstas, deve ser aplicado extensivamente.
A inclusione unius ad exclusionem alterius: Da inclusão de um à exclusão do outro.
A latere: De lado. Argumentação não ligada necessariamente ao fato principal, mas que se acrescenta em reforço.
A limine: Desde o início.
A non domino: Sem título de domínio ou de propriedade. De não proprietário. De quem não é proprietário.
A novo: De novo, novamente.
A pari: Por paridade, por igual razão.
A posteriori: De trás para diante; método que conclui pelos efeitos e conseqüências. Julgar a posteriori é julgar pela experiência. Argumentar a posteriori é argumentar passando do efeito à causa. Para depois. Que vem depois.
A priori: De frente para trás; anteriormente à experiência; método que conclui pelas causas e princípios. Do precedente. De antemão.
A quo: Do qual. Do Juiz ou tribunal de instância inferior de onde provém o processo; dia ou termo inicial de um prazo. Ponto de partida.
A radice: Desde a raiz. Pela Raiz.
A vero domino: Pelo verdadeiro dono.
Ab abrupto: Bruscamente, de repente.
Ab absurdo: Por absurdo. Raciocinando, ou argumentando, com o obsurdo.
Ab abusu ad usum non valet consequentia: O abuso de uma coisa não é argumento contra o seu uso.
Ab accusatione desistere: Desistir de uma acusação.
Ab actis: Dos efeitos, dos autos, que pertence aos autos.
Ab aeterno: Desde a eternidade, há muito tempo.
Ab aliquo: De alguém.
Ab alto: Por alto.
Ab antiquo: De há muito tempo.
Ab executione incipiendum non est: Não se deve iniciar da execução.
Ab immemorabili: Do íntimo do peito.
Ab imo corde: Do mais profundo do coração.
Ab imo pectore: Do íntimo do peito.
Ab initio: Desde o início. Desde o princípio.
Ab initio validi, post invalidi: A princípio, válidos; depois, inválidos.
Ab instantia: De instância.
Ab integro: Não alterado, inteiramente, fielmente.
Ab intestato: Sem deixar testamento. Diz-se da pessoa que faleceu sem deixar testamento.
Ab irato: Em estado de ira.
Ab origine: Desde a origem.
Ab ovo: Desde o ovo, desde o começo.
Ab re esse: Estar fora de propósito.
Ab reo dicere: Falar em favor do réu.
Ab uno discant omnes: Por um, aprendam todos.
Ab utroque latere: De ambos os lados.
Ab utroque parte dolus compensandus: O dolo de ambas as partes compensa-se reciprocamente.
Abdicatio tutelae: Renúncia à tutela.
Aberratio criminis: Erro do crime, desvio do crime.
Aberratio delicti: Erro do criminoso quanto à pessoa da vítima. O erro se dá quanto o agente se engana na escolha da pessoa da vítima, trocando-a involuntariamente por outra. É o Error in persona .
Aberratio finis legis: Afastamento da finalidade da lei.
Aberratio ictus: Erro de alvo, erro do golpe, desvio do alvo. Ocorre quando o agente não atinge a pessoa visada, mas, acidentalmente, uma terceira. É o erro de alvo.
Aberratio personae: Erro de pessoa (o agente atinge pessoa diversa da que pretendia atingir).
Aberratio rei: Erro de coisa.
Abolitio criminis: Extinção do crime.
Absconditum mentis: O escondido da mente.
Absens: Ausente.
Absens heres non est: O ausente não é herdeiro.
Absens non dicitur reversurus: Não se considera ausente o que vai voltar.
Absente reo: Estando ausente o réu.
Absentem laedit cum ebrio qui litigat: Ofende a uma ausente quem discute com um ébrio.
Absolutio ab instantia: Absolvição da instância.
Absolvere debet judex potius in dubio quam condemnare: Na dúvida, deve o juiz antes absolver do que condenar.
Absque bona fide, nulla valet praescriptio: Nenhuma prescrição vale sem a boa-fé.
Abundans cautella non nocet: Cautela abundante não prejudica.
Abusus: Abuso.
Abusus non tollit usum: O fato de ter ocorrido abuso não deve prejudicar o uso.
Abyssus abyssum invocat: O abismo chama outro abismo.
Acceptans actum, cum omnibus suis qualitatibus acceptare videtur: Quem aceita um ato, aceita-o com todas as suas qualidades.
Acceptilatio autem est veluti imaginaria solutio: A aceptilação é, pois, como um pagamento imaginário.
Acceptilatio est liberatio per mutuam interrogationem, quae utrius que contingit ab eodem nexu absolutio: A aceptilação é a libertação por mútua interrogação, pela qual se dá a dissolução do vínculo para ambas as partes.
Acceptilatione unius tollitur obligatio: Por aceptilação de um, suprime-se a obrigação.
Accessio: Acessão.
Accessio cedit principali: O acessório segue o principal, o acessório está compreendido no principal. A acessão cede ao principal.
Accessio nemini proficit, nisi ei, qui ipse possedit: A acessão a ninguém aproveita, senão àquele mesmo que possui.
Accessio possessionis: Acessão da posse.
Accessio temporis: Acréscimo de tempo ou prazo permitido por lei ou previsto em contrato, acessão de tempo.
Accessit: Aproximou-se.
Accessoria sequuntur jus et dominium rei principalis: Os acessórios seguem o direito e o domínio da coisa principal.
Accessorium semper cedit principali: O acessório cede sempre ao principal.
Accessorium sequitur suum principale: O acessório segue o seu principal.
Accessorium sui principalis naturam sequitur: O acessório sempre acompanha a natureza de seu principal.
Accipere iudicium: Receber os termos da sentença.
Accipiens: Que recebe.
Accusare nemo se debet nisi coram deo: Ninguém se deve acusar, exceto na presença de Deus.
Accusatio suspecti tutoris: Acusação do tutor suspeito.
Accusatio testamenti: Acusação do testamento.
Acidente in itinere: Aquele ocorrido no trajeto que o empregado utiliza para ir e voltar do trabalho.
Acta: Atos, autos.
Acta simulata substantiam veritatis mutare non possunt: Os atos simulados não podem mudar a substância da verdade.
Actio: Ação.
Actio ad exhibendum: Ação de exibição.
Actio aestimatoria: Ação estimatória.
Actio aquae pluviae arcendae: Ação de tirada de água de chuva.
Actio arbitraria: Ação arbitrária.
Actio arborum furtim caesarum: Ação de cortar árvores furtivamente.
Actio auctoritatis: Ação de autoridade.
Actio autem nihil aliud est quam jus persequendi in judicio quod sibi debeatur: A ação nada mais é do que o direito de perseguir em juízo o que lhe é devido.
Actio calumniae: Ação de calúnia.
Actio commodati: Ação de comodato.
Actio communi dividundo: Ação de divisão das coisas comuns.
Actio conditio ex mutuo: Ação de pagamento de empréstimo.
Actio conducti: Ação de arrendamento.
Actio confessoria: Ação de confessória.
Actio contratia seu negatoria: Ação contrária ou negatória.
Actio criminalis: Ação criminal.
Actio damni infecti: Ação de dano temido.
Actio damni injuriae: Ação de dano por injúria.
Actio de damno infecto: Ação de dano infecto.
Actio de dote: Ação de dote.
Actio de in rem verso: Ação destinada a recuperar o que obtido à sua custa com locupletamento alheio, ação de locupletamento indevido contra que o obteve.
Actio de edendo: Ação de edição.
Actio de eo quod certo loco dare oportet: Ação do que é preciso ser dado em lugar certo.
Actio de partu agnoscendo: Ação de reconhecimento de parto.
Actio de pastu: Ação de pastagem.
Actio de pauperie: Ação de pobreza.
Actio de peculio: Ação de pecúlio.
Actio depensi: Ação de cobrança de gastos.
Actio depositi: Ação de depósito.
Actio doli: Ação de dolo.
Actio dotis: Ação de dote.
Actio duplex: Ação de dúplice.
Actio est jus persequendi judicio quod sibi debeatur: Ação é o direito de perseguir, diante do magistrado, aquilo que nos é devido.
Actio ex delicto: Ação do delito.
Actio ex empti: Ação de coisa comprada e não entregue.
Actio ex empto: Ação de reivindicação pelo comprador da entrega da coisa vendida.
Actio familae erciscundae: Ação de partilha de herança.
Actio finium resgundorum: Ação de demarcação.
Actio furti: Ação de furto.
Actio furti et damni: Ação de furto e dono.
Actio hypothecaria: Ação de hipotecária.
Actio in personam: Ação pessoal.
Actio in rem: Ação real ou que tem por objeto a propriedade imóvel.
Actio indebiti: Ação do indébito.
Actio judicati: Ação que tem por fundamento a coisa julgada.
Actio jurejurando: Ação por juramento.
Actio libera in causa: Ação livre na causa.
Actio mandati: Ação de mandato.
Actio metus et doli: Ação de medo e de dolo.
Actio negatoria: Ação de negatória.
Actio negotiorum gestorum: Ação do gestor de negócios para haver o reembolso das despesas em virtude da gestão.
Actio non datur nisi constet de corpore delicti: Não se dá a ação se não constar do corpo do delito.
Actio nullitatis: Ação de nulidade.
Actio ob sepulchrum violatum: Ação por violação de sepulcro.
Actio pauliana: Ação pauliana.
Actio personalis moritur cum persona: A ação pessoal extingue-se com o indivíduo.
Actio pignoratitia: Ação de penhor.
Actio popularis: Ação popular.
Actio possessoria: Ação possessória.
Actio quanti minoris: Ação de diminuição de preço.
Actio quod metus causa: Ação por causa do medo.
Actio redhibitoria: Ação redibitória.
Actio rei uxoriae: Ação da coisa da mulher.
Actio rescissoria: Ação rescisória.
Actiones in rem: Ações sobre a coisa.
Actiones poenales: Ações penais.
Actiones praejudiciales: Ações prejudiciais.
Actiones transeunt ad heredes et in heredes: Ações passam para os herdeiros e contra os herdeiros.
Actionum cumulatio regulariter est permissa: A cumulação de ações é regularmente permitida.
Acto causa mortis: Ato por causa da morte.
Actio inter vivos: Ato entre vivos.
Actor agit, quando vult, et non cogitur, sed contrarium est in reo: O autor demanda quando quer, sem poder ser obrigado a isso; quanto ao réu, porém, dá-se o contrário.
Actor et reus idem esse nonn possunt: Autor e réu não podem ser os mesmos.
Actor forum rei sequi debet: O autor deve seguir o foro do réu.
Actor in replicando, actor est: O autor replicando, é autor.
Actor potius credendum est: Deve-se, de preferência, acreditar no autor.
Actor probat actionem: O autor prova a ação.
Actor rei forum sequitur: O autor segue o foro do réu.
Actore non probante, reus absolvitur: Se o autor não prova, o réu é o absolvido.
Actori incumbit onus probandi: Ao autor cabe o ônus da prova.
Actori non licet quod reo denegatur: Ao autor não é lícito o que ao réu se negou.
Actori onus probandi incumbit: Cabe ao autor o ônus da prova.
Actum est: Está terminado.
Actum nihil dicitur cum aliquid superest ad agendum: Nada se diz feito, quando resta alguma coisa a se fazer.
Actus, a principio nullus, nullum producit effectum: O ato nulo desde o princípio não produz nenhum efeito.
Actus agentum nunquam ultra eorum intentionem operantur: O ato nunca produz os efeitos além da intenção dos agentes.
Actus corruit omissa forma legis: O ato é nulo, omissa a forma da lei.
Actus debet interpretari ut aliquid operetur, non ut sit inanis et inutilis: Deve-se interpretar o ato de maneira que produza efeito, não de modo que seja vão e inútil.
Actus in dubio validus interpretari debet: O ato, em caso de dúvida, deve-se interpretar como valioso.
Actus judicialis potentior est extrajudiciali: O ato judicial pode mais que o extrajudiacial.
Actus legitimus: Ato legítimo.
Actus limitatus limitantum producit effectum: Ação limitada produz efeito limitado.
Actus non a nomine sed ab effectu judicatur: Julga-se o ato não pelo nome, mas pelo efeito.
Actus non dicitur perfectus quando partim est factus et partim non: Não se considera o ato perfeito quando uma parte foi feita e outra não.
Actus quo liberi illegitimi jua legitimorum natorum adpiscuntur: É o ato pelo qual os filhos ilegítimos adquirem os direitos dos filhos legítimos.
Actus simulatus nullius est momenti: O ato simulado nenhum valor possui.
Ad accusandum: Para acusar.
Ad adjuvandum: A fim de ajudar, para ajudar.
Ad aemulationem: Para emulação.
Ad agendum: Para agir.
Ad animum: No ânimo.
Ad appellandum: Para apelar.
Ad arbitrium: Segundo a vontade de alguém, conforme o arbítrio.
Ad argumentandum: Para argumentar.
Ad argumentandum tantum: Só para argumentar.
Ad beneplacitum: Segundo o beneplácito (a permissão).
Ad benevolentiam: Para a benevolência.
Ad breve: Por pouco tempo.
Ad captandum vulgus: Para cativar a multidão.
Ad causam: Para a causa.
Ad causam pertinenti: Relativo à causa.
Ad cautelam: Por cautela, por preocupação, por segurança.
Ad colorandam possessionem: Para colorir a posse.
Ad confessionem: Para confessar.
Ad corpus: Por corpo.
Ad defendionem: Para defesa.
Ad deliberandum: Para deliberar.
Ad dicendum: Para dizer.
Ad diem: Até o dia, dia em que termina o prazo.
Ad discendum: Para aprender.
Ad domum: Em casa.
Ad effectum: Para o efeito.
Ad effectum videndi: Para efeito de ver.
Ad evacuando: Para desocupar.
Ad excludendum: Para excluir, eliminar.
Ad exemplum: Para exemplo.
Ad exhibendum: Para exibir.
Ad eximere tempus: Para gastar o tempo.
Ad extra: Por fora.
Ad extremum: Até o fim, até o extremo.
Ad fidem: Com fidelidade.
Ad finem: Até o fim, até o extremo.
Ad futuram memoriam: Para a lembrança futura.
Ad gloriam: Pela glória.
Ad hoc: Para isto, para um determinado ato. Investido em função provisória, para um fim especial (defensor ad hoc, nomeado para um ato de defesa).
Ad hominem: Contra o homem.
Ad honorem: Por honra (diz-se do que é feito de graça, sem interesse lucrativo).
Ad honores: Pelas honrarias.
Ad hunc modo: Assim, desta forma.
Ad id: Para isto.
Ad impossibilia nemo tenetur: Ninguém está obrigado ao impossível.
Ad inferos: Aos infernos.
Ad infinitum: Até o infinito.
Ad instar: À semelhança.
Ad interim: Interinamente, durante este tempo.
Ad intra: Por dentro.
Ad iudicia: Para as coisas da justiça.
Ad judicem agere: Agir perante o juiz.
Ad judicem dicere: Falar na presença do juiz.
Ad judicia: Para o foro judicial.
Ad judicia et extra: Para fins judiciais e extrajudiciais.
Ad judicium: Ao julgamento.
Ad kalendas grecas: Nunca.
Ad libitum: À escolha, à vontade.
Ad litem: Para o litígio.
Ad litteram: Literalmente.
Ad litteris et verbis: Letra por letra, palavra por palavra.
Ad locum: Sem demora, logo.
Ad mandatum faciendi: Para cumprir o mandato.
Ad me: A mim, para mim.
Ad meliorandum: Para melhorar.
Ad mensuram: Por medida.
Ad misericordiam: Por compaixão.
Ad modum: Conforme a maneira.
Ad multos annos: Por muitos anos.
Ad naturam: Conforme a natureza.
Ad nauseam: Até a exaustão, até a saciedade.
Ad necessitate: Por necessidade.
Ad negotia: Para negócios.
Ad nostram consuetudinem: Conforme o nosso costume.
Ad nutum: Por um aceno de cabeça, às ordens de alguém, ao menor sinal. Ex.: funcionário demissível ad nutum, ou seja, por livre vontade da administração.
Ad pariendum: Para parir, gerar, adquirir.
Ad patiendum: Para suportar.
Ad perpetuam rei memoriam: Para que se perpetue a verificação de uma coisa ou fato.
Ad personam: Contra a pessoa.
Ad personam domini: Contra a pessoa do dono.
Ad pompam et ostentationem: Para a pompa e a ostentação.
Ad postremum: Finalmente.
Ad praescriptum: Conforme as ordens.
Ad praesens: Presentemente.
Ad probandum tantum: Apenas para provar.
Ad probationem: Para prova.
Ad processum: Para o processo.
Ad quem: Para quem. Juiz ou tribunal de instância superior para onde se encaminha o processo; dia ou termo final de contagem de um prazo. Ponto de chegada.
Ad referendum: Para apreciação posterior, para aprovação.
Ad rem: À coisa, ao assunto.
Ad salutem: Para salvação.
Ad satiatem: Em grande número, a fartar.
Ad satiem: Em grande número, a fartar.
Ad scribendum: Assunto para ser escrito.
Ad sensum: Pelo sentido.
Ad similia: Por semelhança.
Ad solemnitatem: Formalidade exigida por lei para validade de um ato ou negócio.
Ad solvendum: Para solver.
Ad spem: Quanto à esperança.
Ad substantia negotii: Para a essência do negócio.
Ad summam: Em suma.
Ad te: Para ti.
Ad tempus: A tempo, oportunamente.
Ad terrorem: Para atemorizar.
Ad ultimum: Finalmente.
Ad unguem: Com toda perfeição.
Ad unquem: À unha, com esmero.
Ad usucapionem: Para o usucapião.
Ad usum: Segundo o uso.
Ad usum forensem: Para o uso do foro.
Ad utilitatem: Para utilidade.
Ad validitatem: Para validade.
Ad valorem: Pelo valor.
Ad vanum: Inultilmente.
Ad verbum: Palavra por palavra.
Ad verbum reddere: Traduzir palavra por palavra.
Ad vindictam: Por vingança.
Ad voluntatem: Conforme a vontade.
Addenda: Que se deve juntar.
Addictio: Adjudicação.
Addictio hereditatis: Adjudicação da herança.
Addictio in diem: Adjudicação no dia.
Adfiliatio: Afiliação (adoção).
Adfinitas: Afinidade.
Adgnatio: Agnação (o mesmo que agnatio).
Adhuc sub iudice lis est: A lide está ainda com o juiz.
Adiudicatio: Adição.
Admiror nec rerum solum, sed verborum elegantiam: Admiro não só a elegância das coisas, mas também a das palavras.
Adoptio: Adoção.
Adoptio natura imitatur: A adoção imita a natureza.
Adoptio per testamentum: Adoção por testamento.
Adrogatio: Arrogação, atribuição.
Adseveratis per partem in judicio non contradicens fateri videtur: Quem não contradiz o que foi afirmado pela parte em juízo, parece confessar.
Adulterinus a matre: Adulterino por parte da mãe.
Adulterinus a patre: Adulterino por parte do pai.
Adventicio: Adventício.
Adversus omenes: Contra todos.
Advocati temperet se ab injuria: Abstenham-se os advogados da injúria.
Advocatus fisci: Advogado do físico.
Aequitas: Eqüidade.
Aequitas in paribus causis, paria jura desiderat: Em causas iguais, a eqüidade deseja direitos iguais.
Aequitas religio judicantis: A eqüidade é a religião do julgador.
Aequo animo: Com ânimo eqüo, justo.
Aetas excusationen meretur: A idade merece ser excusada.
Affectio maritalis: Afeição conjugal.
Affectio societatis: Vontade de constituir e manter uma sociedade e sem a qual, nas sociedades de pessoas, não pode ela subsistir.
Affectio tenendi: Vontade de reter a coisa.
Affidavit: Afirmação ou confirmação, declaração jurada (direito tributário).
Affines inter se non sunt affines: Os afins, entre si, não são afins.
Affinitas: Afinidade.
Affinitas affinitatem non parit: A afinidade não gera afinidade.
Affinitas iure nulla successio promittitur: A afinidade, no direito, não assegura nenhuma sucessão.
Affinitas non egredietur ex persona: A afinidade não vem da pessoa.
Affinitatis causa fit ex nuptiis: A causa da afinidade vem das núpcias.
Affirmans probat: Quem afirma prova.
Affirmanti incumbit probatio: A prova incumbe a quem afirma.
Ager privatus: Terra particular.
Ager publicus: Terra pública.
Agere invitus nemo compellitur: Ninguém é compelido a agir contra a vontade.
Agere non valenti non currit praescriptio: A prescrição não corre contra quem não pode agir.
Agnati sunt per patrem ex eadem familia: São agnados (os que derivam), por parte de pai, da mesma família.
Agnatio a patre sit, cognatio a matre: A agnação vem do pai, a cognação da mãe.
Alibi: Em outra parte.
Aliena gratia: Por interesse de terceiro.
Alienatio est omnis actus per quem dominium transfertur: Alienação é o ato pelo qual se transfere o domínio.
Alieni juris: De direito alheio.
Alieno nomine: Em nome alheio.
Alieno nomine detinendi: Deter em nome alheio.
Alienus dolus noceri alteri non debet: O dolo alheio não deve prejudicar a outrem.
Alimenta solum debentur pro tempore quo alimentandus vivit: Só se devem os alimentos pelo tempo que vive o alimentando.
Aliquid novi: Elemento novo.
Aliud est celere, aliud tacere: Uma coisa é ocultar; outra, calar.
Aliud est dare, aliud promittere: Uma coisa é dar; outra, prometer.
Aliud pro alio: Uma coisa pela outra.
Aliunde: Em outra parte.
Allegatio et non probatio, quasi non allegatio: Alegação sem prova é como se não há alegação.
Allegatio partis non facit jus: A alegação da parte não faz direito.
Alter ego: Um outro eu.
Amittere non potest quis, quod suum non fuit: Não se pode perder o que não foi seu.
Analogia juris: Analogia do direito.
Analogia legis: Analogia da lei.
Animo solo possessionem adipisci nemo potest: Ninguém pode adquirir a posse só pela intenção.
Animus: Intenção, vontade, ânimo.
Animus abutendi: Intenção de abusar.
Animus adjuvandi: Intenção de ajudar.
Animus alieno nomine tenendi: Intenção de possuir em nome de terceiro.
Animus ambulandi: Intenção de ir e vir.
Animus apropriandi: Intenção de apropriar-se.
Animus calumniandi: Intenção de caluniar.
Animus cancellandi: Intenção de cancelar.
Animus celandi: Intenção de ocultar.
Animus confidendi: Intenção de confiar.
Animus confitendi: Intenção de confessar.
Animus consulendi: Intenção de consultar.
Animus contrahendae societatis: Intenção de fazer sociedade.
Animus corrigendi: Intenção de corrigir.
Animus defendendi: Intenção de defender.
Animus derelinquendi: Intenção de abandonar.
Animus difamandi: Intenção de difamar.
Animus dolandi: Intenção dolosa de prejudicar.
Animus domini: Com a intenção de ser dono, de agir como dono. De assenhorear-se.
Animus donandi: Intenção de dar.
Animus falsandi: Intenção de falsificar.
Animus furandi: Intenção de furtar.
Animus furtandi: Intenção de furtar.
Animus infringendi: Intenção de infringir.
Animus injuriandi: Com a intenção de injuriar.
Animus jocandi: Intenção de gracejar.
Animus laedendi: Intenção de ofender.
Animus lucrandi: Intenção de lucrar.
Animus ludendi: Intenção de brincar.
Animus manendi: Intenção de fixar residência.
Animus narrandi: Intenção de narrar.
Animus necandi: Com intenção de matar.
Animus nocendi: Com a intenção de prejudicar.
Animus novandi: Com a intenção de inovar uma obrigação.
Animus obligandi: Intenção de obrigar.
Animus possidendi: Intenção de possuir.
Animus recipiendi: Intenção de receber.
Animus rem sibi habendi: Com a intenção de ter a coisa para si.
Animus restituendi: Intenção de restituir.
Animus retinendi possessionem: Intenção de conservar a posse.
Animus simulandi: Intenção de simular.
Animus solvendi: Intenção de pagar.
Animus violandi: Intenção de violar.
Anno domini: No ano do Senhor.
Ante acta: Antes do ato, preliminarmente.
Ante diem: Antes do dia.
Ante litem: Antes da lide.
Ante nuptias: Antes do casamento.
Apices juris non sunt jura: As culminâncias do direito não são os direitos.
Appellatio admittenda videtur in dubio: Na dúvida, deve-se admitir a apelação.
Approbare censetur rem vel personam qui ea utitur: Quem usa de uma coisa ou pessoa parece aprová-la.
Approbare quis non potest, quod semel impugnavit: Não pode alguém aprovar o que já impugnou uma vez.
Apud: Junto de.
Apud acta: Na ata, nos autos (Ex.: procuração outorgada na ata da audiência).
Apud aures nostras: Em nossa presença.
Aqua profluens et mare, jure naturali omnium communia sunt: A àgua corrente e o mar são comuns a todos por Direito Natural.
Arbores quae in fundo continentur non est separatum corpus a fundo: As árvores que estão contidas em uma propriedade não são um corpo separado da propriedade.
Auctoritas prudentum: A autoridade dos jurisconsultos.
Audiatur et altera pars: Que a parte contrária seja também ouvida.
Aura popularis: A aura popular.
Aura sacra fames: A ambição do ouro (dinheiro). 
Bella matribus detestata: A guerra detestada pelas mães.
Bene tibii: À tua saúde.
Beneficio principis: Por favor do príncipe.
Beneficium cedendarum actionum: Benefício de cessão de ações.
Beneficium fortunae: Circunstância favorável.
Beneficium juris nemini est denegandi: A ninguém deve ser denegado o benefício do direito.
Beneficium legis frustra implorat qui committit in legem: Em vão implora o benefício da lei, quem age contra ela.
Bis: Duas vezes.
Bis dat qui cito dat: Quem dá depressa dá duas vezes.
Bis de eadem re ne sit actio: Não haja ação duas vezes sobre a mesma coisa.
Bis in idem: Duas vezes a mesma coisa, repetição.
Bis terque beatii: Felizes e mais que felizes.
Bona est lex si quis ea legitime utatur: Boa é a lei se alguém dela usar legitimamente.
Bona fide: De boa-fé.
Bona fides est primum mobile et spiritus vivificans commercii: A boa-fé é o primeiro móvel e o espírito vivificador do comércio.
Bona fides non patitur ut bis idem exigatur: A boa-fé não tolera que a mesma coisa seja exigida duas vezes.
Bona fides semper praesumitur nisi mala adesse probetur: Sempre se presume a boa-fé, se não provar-se existir a má.
Bona gratia discedere: Separação ou divórcio por mútuo consenso.
Bona instantia se uti, non calumniae causa se infitias ire: Deve litigar com razão e não contradizer com calúnias.
Bona publica: Bens públicos.
Boni mores: Bons costumes.
Bonorum possessio ventris nomine: Posse de bens em nome da herança.
Bonus pater familiae: Bom pai de família. Homem cumpridor de seus deveres.
Bonus quilibet praesumitur: Presume-se que todos sejam bons.
Brevi ante: Pouco antes.
Busilis: Dificuldade. 
Calumnia litium: Trapaça das lides.
Calumniare est falsa crimina intendere: Caluniar é imputar crimes falsos.
Capitis diminutio: Perda dos direito civis, redução de direito.
Capitis minutio est status permutatio: A diminuição de capacidade é uma mudança de estado.
Caput: Cabeça de artigo que inclui parágrafos, itens ou alíneas.
Casus adversi: Caso adverso.
Casus belli: Caso de guerra.
Casus foederis: Causa de aliança.
Casus fortuitus: Caso fortuito.
Causa adquirendi: Causa de aquisição.
Causa agendi: Motivo de agir.
Causa cognita: Causa conhecida.
Causa cognoscitur ab effectu: Conhece-se a causa pelo efeito.
Causa criminalis non praejudicat civilis: A ação criminal não prejudica a civil.
Causa debendi: Causa da dívida.
Causa detentionis: Causa da detenção.
Causa donandi: Causa da doação.
Causa honoris: Por causa da honra.
Causa mortis: Causa determinante da morte.
Causa petendi: O fundamento do pedido.
Causa principalis semper attendi debet: A causa principal deve ser sempre atendida.
Causa simulandi: Causa da simulação.
Causa sine qua non: Causa sem a qual a coisa (ato) não pode ser feita.
Causa superveniens: Causa superveniente.
Causidicus: Advogado.
Cautelae: Cautelas.
Cautio: Caução.
Cautio damnini infecti: Caução do dano temido. Caução do proprietário de prédio em favor de vizinho como garantia de que não será molestado.
Cautio de bene utendo: Caução para usar bem.
Cautio de bene vivendo: Caução para viver bem.
Cautio de judicato solvendo: Caução para pagamento do julgado.
Cautio de opere demoliendo: Caução prestada pelo nunciado para continuação de obra embargada de que reste prejuízo se paralisada.
Cautio de rato: Caução para ratificação.
Cautio de restituendo: Caução para restituição.
Cautio fideijussoria: Caução fidejussória.
Cautio rei uxoriae: Caução do dote da mulher.
Cave ne cadas: Acautela-te para não caíres.
Cessante causa, tollitur effectus: Cessando a causa, tira-se o efeito.
Cessio: Cessão.
Cessio bonurum: Cessão dos bens.
Circa merita: A respeito dos méritos.
Citatio: Citação.
Citatio est fundamentum totius judicii: A citação é o fundamento de todo direito.
Citatur reus ad petitionem actoris: Cita-se o réu a pedido do autor.
Citra petita: Aquém do pedido, sentença que não examinou todos os pedidos de uma inicial.
Citra petitum: Aquém do pedido.
Cives totius mundi: Cidadão do mundo inteiro.
Clandestina possessio: Posse clandestina.
Coelibes esse prohibento: Sejam proibidos os celibatos.
Coercitio: Repressão.
Cogitationis poenam nemo patitur: Ninguém pode sofrer pena pelo pensamento.
Cogito, ergo sum: Penso, logo existo.
Cognita causa: Após o exame dos fatos.
Cognitio: Conhecimento.
Cognitio extra ordinem: Conhecimento fora de ordem.
Colorem habent, substantiam vero nullam: Tem aparência, mas não possui substância.
Commendare nihil aliud est quam deponere: Depositar nada mais é do que confiar.
Commercium est emmendi vendendique invicem jus: O comércio é o direito de comprar e vender mutuamente.
Communio: Comunhão.
Communis error: Erro comum.
Compensatio est instar solutionis: A compensação é semelhante de pagamento.
Compos sui: Senhor de si.
Concessa venia: Com a devida licença.
Concursos delictorum: Concurso de crimes.
Concursos delictorum realis: Concurso real de delitos.
Concursos delinquentium: Concurso de criminosos, co-autoria.
Condictio: Acordo.
Conditio juris: Condição de direito.
Conditio potestativa: Condição potestativa. Condição que depende no todo ou em parte da vontade de um dos contratantes.
Conditio sine causa: Condição sem causa.
Conditio sine qua non: Condição indispensável.
Confessio dividi non debet: Não se deve dividir a confissão.
Confessio est probatio omnibus melior: A confissão é a melhor de todas as provas.
Confessio est regina probationum: A confissão é a rainha das provas.
Confessio facta in judicio non potest retractari: Não pode ser retratada a confissão feita em juízo.
Confiteor: Eu confesso.
Congruo tempore et congruo loco: Em tempo e lugar certos.
Consanguineos, id est, fratres et sorores ex eodem patre: Consagüíneos, isto é, os irmãos e irmãs por parte do mesmo pai.
Conscientia fraudis: Consciência da fraude.
Conscius fraudis: Consciente da fraude.
Consensus omnium: O consenso de todos.
Consensus tollit erroren: O consentimento tira o erro.
Consuetudo: Costume.
Consuetudo fori: Costume do foro.
Consuetudo revertendi: Costume de voltar.
Consumitur altera actio per alteram: Uma ação consome-se por outra.
Consummatum est: Tudo está consumado.
Contentio inter partes: Divergência entre as partes.
Contestationes causa: Diz-se da causa que é objeto de contestação.
Contra jus: Contra o direito.
Contra legem: Contrário à lei.
Contumacia est actus spernendi leges: Contumácia é o ato de desprezar a lei.
Contumacia in non respondendo: Contumácia em não responder.
Cor hominis immutat faciem ejus: O coração do homem lhe muda a face.
Coram lege: Perante a lei.
Coram populo: Em público.
Coram testibus: Em presença de testemunhas.
Corpus alienum: Corpo estranho.
Corpus delicti: Corpo de delito.
Corpus juris civilis: Código de Direito Civil.
Corruptio: Corrupção.
Crimen privilegiatum: Crime privilegiado.
Crimina intendere: Diminuição de capacidade.
Cuique suum: A cada um o que é seu.
Culpa aquiliana: Culpa aquiliana, culpa extracontratual.
Culpa est non praevidere quod facile potest evenire: É culpa não prever o que facilmente pode acontecer.
Culpa in abstracto: Culpa em abstrato.
Culpa in commitendo: Culpa por imprudência.
Culpa in concreto: Culpa em concreto.
Culpa in contrahendo: Culpa no contratar.
Culpa in eligendo: Culpa pela escolha de seus prepostos.
Culpa in faciendo: Culpa na forma de prestar a obrigação.
Culpa in omittendo: Culpa de omissão que resultou em dano.
Culpa in vigilando: Culpa em vigiar a execução de que outrem ficou encarregado.
Culpa ubi non est, nec poena esse debet: Onde não existe culpa, não deve haver pena.
Cum errantis nulla volutas sit: Quem erra não tem vontade.
Cum grano salis: Com um grão de sal. O enunciado não se deve tomar a sério - temperado que foi com um grão de sal.
Cum laude: Com louvor.
Cum reus moram facit et fidejussor tenetur: Quando o réu incorre em mora, o fiador é responsável.
Currente calamo: Ao correr da pena.
Curriculum vitae: Currículo demonstrativo ou relação de títulos da pessoa.
Custas ex lege: Custas como de lei.
Custos legis: Fiscal da lei. 
Da mihi factum, dabo tibi jus: Exponha o fato e direi o direito. Exposto o fato, o magistrado aplicará o direito, ainda que não alegado o dispositivo legal.
Damnatio: Condenação.
Damnum: Dano.
Damnum emergens: Dano emergente.
Damnum ex delicto: Dano por delito.
Damnum infectum: Dano temido.
Damnum injuria datum: Dano produzido pela injúria.
Dare et remittere paria sunt: Dar e perdoar são coisas iguais.
Dare in solutum est vendere: Dar em pagamento é vender.
Dare nemo potest quod non habet: Ninguém pode dar o que não tem.
Data venia: Com respeito, com licença. Fórmula de cortesia com que se começa uma argumentação para discordar do interlocutor. Com a devida permissão. É o mesmo que concessa venia ou permissa venia.
Datio in solutum: Dação em pagamento.
Datur: É permitido.
De auditu: Por ouvir dizer.
De cujus: O falecido, geralmente empregado como a pessoa inventariada.
De cujus succssione agitur: Aquele de cuja sucessão se trata.
De jure: De direito.
De jure constituendo: Pelo direito ainda não vigente.
De jure constituto: Pelo direito vigente.
De jure sacro: Do direito sagrado.
De lege ferenda: Pela lei ainda a ser promulgada - direito in fieri.
De lege lata: Pela lei existente em sentido amplo.
De meritis: Pelo mérito ou merecimento. Resolvidas as questões prévias da causa, examina-se o mérito, ou seja, a questão de fundo.
De minimis non curat lex: A lei não cuida de coisas mínimas.
De minimis non curat praetor: O magistrado não deve preocupar-se com as questões insignificantes.
De more uxorio: De costume do matrimônio. Concubinato em que os concubinos convivem como se casados fossem.
De persona ad personam: De pessoa a pessoa.
De plano: Sumariamente, por direito evidente.
De visu: De vista.
Debellatio: Derrota.
Decisio litis: Decisão da causa.
Decisorium litis: Ato decisório da lide.
Decisum: Decisão, sentença.
Decoctus perdit administrationem suorum sonorum: O falido perde a administração de seus bens.
Decoctus semper culposus praesumitur, donec contrarium probetur: Sempre se presume culpado o falido, até prova em contrário.
Defensa: Defesa.
Deficit: Saldo negativo.
Degitor sui ipsius nemo esse potest: Ninguém pode dever a si mesmo.
Delatio: Delação.
Delicta carnis: Os delitos da carne.
Delicta facti permanentis: Os delitos praticados com vestígios.
Delicta omissionis: Crimes de omissão.
Delictum non praesumitur in dubium: Não se presume o delito na dúvida.
Derelictio: Abandono.
Derelictum: Abandonado.
Dictum unius, dictum nulliu: Palavra de um, palavra de nenhum.
Dies a quo: Termo inicial do prazo, em contraposição ao dies ad quem.
Dies ad quem: Termo final do prazo.
Dies cedit: Dia inicial.
Dies certus: Dia certo.
Dies incertus: Dias incerto.
Dies interpellat pro homine: O termo (prazo, data certa) interpela pelo homem.
Dies pecuniae: Dia de pagamento.
Dies termini computatur in termino: O dia do vencimento se conta no termo.
Dies venit: Dia do vencimento.
Dignus est operarius merce sua: O operário é digno de seu salário.
Diminutio patrimonii: Diminuição do patrimônio.
Divini juris sunt veluti res sacrae et religiosae: São de direito divino as coisas sagradas e religiosas.
Dolus a fraude differt velut genus auspecie: O dolo difere da fraude como o gênero, da espécie.
Dolus apertus: Dolo que se pode ver na conduta do agente.
Dolus bonus: É o dolo involuntário do agente, há intenção boa e resultado mau.
Dolus malus: Quando a vontade do agente quis o mau resultado.
Dolus non praesumitur nisi probetur: Não se admite o dolo que não se possa provar.
Dolus velatus: O dolo é velado e o agente tenta disfarcá-lo.
Dominium est jus utendi fruendo et abutendi re sua quatenus juris ratio patitur: O domínio é o direito de usar, fruir e dispor do que é seu, quanto o permite a razão do direito.
Dominus litis: O autor da ação; o dono da lide.
Dominus soli: Dono do solo.
Donatio mortis causa: Doação por motivo de morte.
Donatio omnium bonorum, reservato sibi usufructo, valida est: É válida a doação de todos os bens, reservando para si o usufruto.
Donatio sub modo: Doação por condição.
Dormientibus non succurrit jus: O direito não ajuda aos que dormem ou negligenciam em seu uso ou defesa.
Dubia in meliorem partem interpretari debent: Coisas duvidosas devem ser interpretadas pelo lado melhor.
Dum pendet, rendet: Enquanto pende, rende.
Dura lex sed lex: A lei (é) dura, mas (é) lei. A lei deve ser aplicada ainda que pareça imoral ou injusta. Preceito a ser aplicado em termos. 
Eadem: O mesmo.
Electa una via non datur regressus ad alteram: Escolhida uma via, não se dá recurso a outra.
Elementa essentialia communia delicti: Os elementos essenciais comuns do delito.
Emptio consensu peragitur: A compra se completa pelo consentimento.
Erga alios: Contra a outra parte.
Erga omnes: Para com todos. O que é válido contra todos.
Ergo: Portanto.
Errare humanum est: Errar é humano.
Errata: Erros, corrigenda.
Error calculi non facit jus: O erro de cálculo não faz direito.
Error facti: Erro de fato.
Error facti nemini nocet: O erro de fato não prejudica ninguém.
Error in judicando: Erro no julgar.
Error in persona: Erro sobre a pessoa visada. Erro quanto à pessoa.
Error in procedendo: Erro no proceder.
Error juris: Erro de direito.
Error juris non excusat: O erro de direito não inocenta.
Est modus in rebus: Em tudo deve haver um meio termo.
Eventus damni: Resultado do dano.
Ex abrupto: De súbito.
Ex adverso: Pelo contrário.
Ex auctoritate legis: Por força da lei.
Ex auditu alieno: Por bom e igual.
Ex commodo: À vontade.
Ex consensu: Com consentimento.
Ex consuetudine: Conforme o costume.
Ex die: Prazo inicial.
Ex facto jus oritur: Do fato nasce o direito.
Ex facto oritur jus: O direito nasce do fato.
Ex improviso: De improviso.
Ex intervallo: Após um lapso de tempo.
Ex jure: Pelo direito.
Ex jure alieno: Por direito de terceiro.
Ex lege: De acordo com a lei.
Ex libris: Dos livros.
Ex nihilo nihil: Do nada, nada. Nada pode vir do nada.
Ex nunc: Desde agora. Nulidade de ato ex nunc, cujos efeitos decorrem a partir da declaração de nulidade. Não retroage.
Ex officio: Por dever do ofício. Recurso ex officio, obrigatoriamente imposto ao juiz contra a própria sentença.
Ex positis: Isto posto. Do que foi exposto.
Ex potestate legis: Por força da lei.
Ex probatione oritur fides juridica: Da prova nasce a fé jurídica.
Ex professo: Por sua autoridade ou experiência.
Ex propria auctoritate: Por autoridade própria.
Ex proprio jure: Por direito próprio.
Ex proprio marte: Por força própria.
Ex radice: Da raiz.
Ex rigore juris: Conforme o rigor da lei.
Ex tempore: De pronto, imediatamente.
Ex tunc: Desde o início. Nulidade de ato ex tunc, cujos efeitos decorrem a partir da criação do ato que gerou a nulidade.
Ex vi: Consoante o disposto, pela força.
Ex vi contractu: Conforme a promessa.
Ex vi legis: Por força da lei.
Exceptio: Ação de executar, de limitar.
Exceptio declinatoria fori: Ação declinatória do foro.
Exceptio doli: Exceção de dolo.
Exceptio domninii: Exceção de domínio.
Exceptio maioris causae: Exceção de causa maior.
Exceptio veritate: Exceção da verdade.
Exceptiones: Exceção.
Excessus defensionis: Excesso de defesa.
Excipiens: Excipiente.
Exempli gratia (e.g.): Por exemplo. O mesmo que verbi gratia (v.g.).
Exequatur: Execute-se. Cumpra-se.
Extra litis: Fora da demanda.
Extra petita: Fora do pedido. Sentença que concedeu o que não constitui objeto do pedido. 
Fac simile: Reprodução fiel de um original.
Fac totum: O que faz tudo.
Facit jus inter partes: Faz direito entre as partes.
Facti species: Particularidade do fato, espécie do fato.
Factum adserverans onus subiit probationis: Quem atesta um fato, assume o ônus da prova.
Factum et transactum: Feito e passado.
Factum negantis, nulla probatio est: Nenhuma prova se exige de quem nega o fato.
Facultas agendi: Poder de ação, faculdade de agir (direito subjetivo).
Falsa demonstratio non nocet: A demonstração errada ou imprópria não deve prejudicar o direito alegado.
Fama volat: A fama voa.
Ficta confessio: Confissão fictícia. Se o citado não comparecer à audiência, devem ser considerados confessados ou verdadeiros os fatos alegados pelo autor.
Fictio juris: Ficção jurídica.
Fictio legis: Ficção da lei.
Filius, ergo heres: Filho; logo, herdeiro.
Finita causa, cessat effectus: Finda a causa, cessa o efeito.
Forma dat esse rei: A forma dá existência à coisa; a forma é necessária à existência da coisa. A escritura pública é necessária à existência da transferência da propriedade imóvel.
Forum contractus: Foro do contrato.
Forum rei sitae: O foro da situação da coisa.
Fraus legis: Fraude à lei.
Fraus omnia corrumpit: A fraude tudo corrompe, ou produz nulidade.
Fumus boni juris: Fumaça de bom direito, aparência de bom direito (diz-se quando a pretensão parece ter fundamento jurídico).
Furiosum nullum negotium contrahere potest: O louco não pode contrair negócio algum. 
Genera per speciem derogantur: Os gêneros derrogam-se pela espécie.
Generalistas parit obscuritatem: A generalidade gera a obscuridade.
Genus nunquam perit: O gênero nunca se destrói.
Grammatica falsa non vitiat instrumentum: Os erros gramaticais não viciam o instrumento.
Gratia argumentandi: Para argumentar.
Gratis: De graça.
Grave est fidem fallere: É grave faltar à fidelidade.
Gravis testis: Testemunha fidedigna.
Gutta cavat lapidem: A gota cava a pedra. 
Habeas corpus: Que tu tenhas o corpo.
Habeas data: Que tu tenhas os dados.
Habetur pro veritate: Tem-se por verdade.
Habitatio morte finitur: A habitação acaba com a morte.
Hastae subjicere: Vender em leilão público.
Hereditas viventis non datur: Não há herança de pessoa viva.
Hic et nunc: Aqui e agora, imediatamente, sem demora.
Hic et ubique: Aqui e em toda parte.
Hoc erat in votis: Estes eram os meus votos.
Hoc ipsum est: Eis o caso.
Hoc opus, hic labor est: Esse é o trabalho, essa é a fadiga.
Hodie mihi, cras tibi: Hoje para mim, amanhã para ti.
Homo forensis: O advogado.
Homo sapiens: Homem racional.
Honoris causa: Por título honorífico. 
Ibidem: No mesmo lugar.
Ictu oculi: Percebido pelos olhos.
Id est: Isto é, ou seja.
Idem: O mesmo.
Ignorantia juris neminem excusat: A ignorância da lei não excusa ninguém.
Imprimatur: Imprima-se.
Imputatio facti: Imputação de um fato.
Imputatio juris: Imputação de um direito.
In abstrato: Em abstrato.
In actu: No ato.
In aeternum: Eternamente; para sempre.
In albis: Em branco.
In casu: Na espécie em julgamento.
In casu consimili: Em caso semelhante.
In censura: Em censura.
In concreto: Em concreto.
In continenti (= ex intervallo): No início do contrato, imediatamente.
In contione: Publicamente.
In diem: Para um dia não determinado.
In dubio, contra fiscum: Na dúvida, contra o fisco.
In dubio pro matrimonio: Na dúvida, pelo matrimônio.
In dubio pro operatio: Em caso de dúvida, deve-se beneficiar o empregado.
In dubio pro reo: A dúvida interpreta-se a favor do acusado.
In dubio pro societate: Na dúvida, deve-se interpretar a norma a favor da sociedade.
In extenso: Por extenso.
In extremis: No último momento.
In faciendo: No fazer.
In fieri: A se construir, a se formar.
In fine: No fim.
In flagranti: Em flagrante.
In fraudem legis: Em fraude da lei.
In illo tempore: Naquele tempo.
In initio litis: No começo da lide.
In judicio: Diante do juiz.
In limine: No começo.
In limine litis: No começo da lide.
In litem: Na lide.
In loco: No lugar.
In memoriam: Em lembrança de.
In natura: Na natureza, da mesma natureza.
In pari causa: Em caso semelhante.
In radice: Na raiz, no começo.
In situ: No local.
In solidum: Solidariamente.
In specie: Em espécie.
In terminis: Em último lugar.
In totum: No todo, na totalidade.
In verbis: Nas palavras, nestes termos, textualmente.
Inaudita altera parte: Não ouvida a outra parte.
Incidenter: Incidentalmente.
Informatio delicti: Investigação criminal, informação sobre o delito.
Infra: Abaixo.
Initio litis: No começo da lide.
Instar omnium: Como faz toda a gente.
Instrumenta sceleris: Os instrumentos utilizados na prática do crime.
Intentio legis: A finalidade da lei.
Inter absentes: Entre ausentes.
Inter alia: Entre outras coisas.
Inter alios: Entre outros.
Inter vivos: Entre os vivos.
Interna corporis: Interno. No âmbito do próprio órgão.
Interposita persona: Por meio de um intermediário.
Interpretatio cessat in claris: A interpretação cessa nas coisas claras.
Intra legem: Interpretação analógica determinada na própria lei.
Intra muros: Dentro dos muros.
Intuitu personae: Em consideração à pessoa. Obrigação contraída.
Ipsis litteris: Exatamente igual; com as mesmas letras.
Ipsis verbis: Exatamente igual; com as mesmas palavras.
Ipso facto: Pelo próprio fato.
Ipso jure: Em razão do próprio direito, sem intervenção da parte.
Is pater est, quem justas nuptiae demonstrat: Pai é quem se casou com a mulher de quem nasceu o filho.
Ita est: Assim é.
Ita lex dicit: Assim diz a lei.
Ita speratur: Assim se espera.
Iter: Procedimento, etapas.
Iter criminis: Caminho do crime - atos que se encadeiam na execução do crime.
Iuris et de iure: De direito e por direito. 
Judex extra territorium est privatus: Fora de sua jurisdição, o juiz é um particular.
Judex idoneus: Juiz idôneo.
Judex non debet lege esse clementior: O juiz não deve ser mais clemente do que a lei.
Judex ultra petita condemnare non potest: O juiz não pode condenar além do pedido.
Judicium accusationis: Juízo da acusação.
Judicium causae: Juízo da causa.
Jura novit curia: O Tribunal (o juiz) conhece os direitos.
Jure constituendo: Pelo direito a constituir.
Jure et de facto: Por direito e de fato.
Jure proprio: Por direito próprio.
Juris et de jure: De direito e por direito. Presunção que não admite prova em contrário
Juris tantum: Somente de direito, a admitir prova em contrário
Jus accusationis: Direito de acusar.
Jus ad rem: Direito à coisa.
Jus agendi: Direito de agir.
Jus cogens: Direito cuja aplicação é obrigatória pela parte e não pode ser afastado pela vontade de particularidades.
Jus constituendum: Direito a se constituir.
Jus constitutum: Direito constituído.
Jus empirii: Direito da autoridade, direito do governo, direito do que tem o poder.
Jus est ars boni et aequi: O direito é a arte do bom e do justo.
Jus est norma agendi: O direito é a norma de agir.
Jus eundi: Direito de ir e vir.
Jus ex facto oritur: O direito nasce do fato.
Jus facit judex: O juiz faz o direito.
Jus gentium: O direito das gentes.
Jus in re: Direito sobre a coisa, direito de propriedade.
Jus in re aliena: Direito sobre a coisa alheia (usufruto, hipoteca).
Jus in re propria: O direito sobre coisa própria.
Jus libertatis: Diretio à liberdade.
Jus persequendi: Direito de perseguir.
Jus possessionis: O direito de posse.
Jus possidendi: Direito de posse.
Jus sanguinis: Direito de punir.
Jus sanguinis: O direito de sangue, de parentesco.
Jus strictum: Direito de aplicação estrita ou rígida.
Jus suffragii: Direito do voto.
Jus suum unicuique tribuere: Dar a cada um aquilo a que tem direito.
Justae nuptiae: Justas núpcias.
Justum pretium: Preço justo.
Lana caprina: Questão insignificante.
Lapsus calami: Erro de caneta.
Lapsus linguae: Erro de linguagem.
Lapsus loquendi: Erro no falar.
Lapsus scribendi: Erro no escrever.
Lata culpa: Negligência excessiva.
Lato sensu: Em sentido geral.
Laudum: Decisão arbitral.
Lege lata: Pela lei tomada em seu sentido amplo, pela lei extensamente.
Legem habemus: Temos leis.
Legis manus longa: A mão da lei é longa.
Legitima aetas: Idade legítima, maioridade.
Legitimatio ad causam: Legitimação para a causa.
Legitimatio ad processum: Legitimação de estar em juízo.
Lex ad tempus: Lei temporária.
Lex inter partes: Lei entre as partes.
Lex lata: Lei promulgada.
Lex loci: A lei do lugar.
Lex loci actus: Lei do lugar do ato.
Lex loci contractus: Lei do lugar do contrato.
Lex mitior: Lei mais benigna.
Lex posterior derogat priori: A lei posterior derroga a anterior.
Libenter: De boa vontade.
Litigare cum ventis: Brigar com o vento.
Litis contestatio: Contestação da lide.
Litis decisio: Decisão da lide.
Locus delicti commissi: Lugar onde cometido o crime.
Locus regit actum: O lugar determina o ato.
Lucrum cessans: Lucro cessante. 
Magis aequo: Mais do que justo.
Magister dixit: O mestre disse.
Mandamus: Mandado de segurança.
Mandatum non praesumitur: Não se presume o mandato.
Mandatum solvitur morte: Com a morte resolve-se o mandato.
Manu militari: Com poder militar, ação executada à força.
Manus mariti: Poder do marido.
Mater semper certa est: A mãe é sempre certa.
Maxime: De modo especial, especialmente.
Me ignaro: Sem eu saber.
Medius mensis: Meados do mês.
Mens legis: O espírito da lei, intenção da lei.
Mens legislatoris: Intenção do legislador.
Meritum causae: Mérito da causa.
Merum jus: Direito estrito.
Meta optata: Resultado desejado.
Minervae suffragium: Voto de minerva.
Mirabile dictu: Coisa admirável de se dizer.
Modus faciendi: Maneira de fazer.
Modus operandi: Modo de operação.
Modus vivendi: Maneira de viver.
Mora creditoris: Mora do credor.
Mora debitoris: Mora do devedor.
Mora ex re: Mora que provém da coisa.
Mora in solvendo: Mora em pagar.
Mors omnia solvit: A morte solve tudo.
Mortis causa: Por causa da morte. Obrigações e direitos conseqüêntes da morte e que passam aos herdeiros.
Motu proprio: Por própria iniciativa.
Munus publicum: Encargo público.
Mutatis mutandis: Mudado o que deve ser mudado. Fazendo-se as devidas mudanças.
Naturali jure: Por direito natural.
Naturalis ratio: A razão natural.
Ne bis in idem: Não duas vezes no mesmo assunto.
Ne verbum quidem: Nem sequer uma palavra.
Nec plus ultra: Aquilo que não pode ir além.
Necessitas facit ius: A necessidade faz o direito.
Nemine discrepante: Sem discrepância; por unanimidade, sem que ninguém divergisse.
Neminem ignorantia legis excusat: A ignorância da lei não escusa ninguém.
Nemo auditur propriam turpitudinem allegans: A ninguém é dado alegrar a própria torpeza em seu proveito.
Nemo dat quod non habet: Ninguém dá o que não tem.
Nemo debet inauditus damnari: Ninguém deve ser condenado sem ser ouvido.
Nemo deferre se cogitur: Ninguém é obrigado a se denunciar.
Nemo demnatur nisi per legale judicium: Ninguém pode ser condenado a não ser em um juízo legal.
Nemo judex sine lege: Ninguém é juiz sem lei.
Nemo potest ignorare leges: A ninguém é dado alegar a ignorância da lei.
Nihil medium est: Não há meio-termo.
Nihil obstat: Nada impede.
Nomem juris: Nome de direito. Título do crime.
Nominatim: Nominalmente, expressamente.
Non bis in idem: Ninguém deve ser julgado duas vezes pelo mesmo fato.
Non decet: Não convém.
Non facere quod debet facere: Não fazer o que deve fazer.
Non hilum: Absolutamente nada.
Non liquet: Não há certeza, não está claro. Não há julgado. Não convence.
Norma agendi: O direito como norma, lei ou regra de ação (direito objetivo). Norma de conduta.
Nota bene: Note bem.
Notitia criminis: Notícia ou conhecimento do crime. Comunicação do crime.
Novum iudicium: Novo julgamento.
Nuda repromissio: Simples promessa.
Nulius iuris: Sem valor para o direito.
Nulla actio sine lege: Sem lei não há ação.
Nulla poena sine judicio: Não há pena sem processo.
Nullo labore: Sem trabalho algum, sem custo.
Nullum crimen, nulla poena sine praevia lege: Não há crime, nem pena sem lei anterior que os defina.
Nullum crimen sine culpa: Não há crime sem culpa.
Nullum crimen sine lege: Não há crime sem lei (anterior que o defina).
Nullum ius sine actione: Não há direito sem ação.
Nullum tributum sine praevia lege: Não há tributo sem lei anterior.
Numerus apertus: Número ilimitado.
Numerus clausus: Número limitado.
Nunc aut nunquam: Agora ou nunca.
Nunc et semper: Agora e sempre.
Obligatio ad diligentiam: Obrigação de ser diligente.
Obligatio faciendi: Obrigação de fazer.
Obligatio non faciendi: Obrigação de não fazer.
Oblivio signum negligentiae: Esquecimento é sinal de negligência.
Obscure dictum habetur pro non dictum: O que se disse de modo obscuro, tem-se por não dito.
Occasio legis: Circunstâncias do momento em que se originou a lei utilizada na interpretação lógica.
Odiosa restringenda, favorabilia amplianda: Restrinja-se o odioso; amplie-se o favorável. Refere-se a que, em princípio, as disposições que restringem direitos devem ser devem ser interpretadas de forma estrita.
Omissis: Omitido, trecho omitido.
Omni ope: Com maior esforço, com todo o empenho.
Omnium consensu: Pelo consenso de todos.
Omnium horarum homo: Homem de todas as horas.
Onus probandi: O encargo da prova.
Ope juris: Por força do direito.
Opportune tempore: No tempo oportuno.
Ordinatorium litis: Instrução do processo.
Pacta clara, boni amici: Ajustes honestos, bons amigos.
Pacta sunt servanda: Os contratos devem ser cumpridos.
Pactum sceleris: Pacto do crime.
Palliae sunt: São palhas, são ninharias.
Pari passu: Simultaneamente, a par.
Passim: Aqui e ali - fórmula para indicar que, após uma citação, outras igualmente são encontráveis.
Patria potestas: Poder pátrio.
Pendente lite: Enquanto pende a lide.
Per capita: Por cabeça, por pessoa.
Per contra: em sentido contrário.
Per dolum: Dolorosamente, por dolo.
Per legem terrae: Pela lei do seu país.
Per litteras: Por carta.
Per ludum: Por brincadeira.
Per se: Por si mesmo.
Per se stante: Por si próprio.
Per summa capita: Em resumo, sucintamente.
Per tempus: A tempo, em tempo.
Per vim: Com violência.
Periculum in mora: Perigo de mora, perigo na demora.
Permissa venia: Com o devido respeito.
Persecutio criminis: Persecução criminal. Perseguição do crime.
Persona grata: Pessoa bem-vinda.
Petitio principii: Petição de princípio, sofisma que supõe verdadeiro o que ainda deve ser provado.
Petitum: Pedido.
Placet: Agrada, aprova.
Pleno gradu: A toda pressa.
Pleno jure: De pleno direito.
Plurimus: Diversos, muitos.
Plus aequo: Mais do que justo. Com demasiado rigor.
Plus justo: Além da medida, excessivamente.
Plus ultra: Mais além.
Possessio bonae fidei: Posse de boa-fé.
Post factum: Depois do fato.
Post mortem: Depois da morte.
Post scriptum: Depois do escrito.
Praesumptio juris et de jure: Presunção absoluta que não admite prova em contrário.
Praeter legem: Espécie de costume que integra a norma penal não incriminadora, quer cobrindo-lhe as lacunas, quer lhe especifacando-lhe o conteúdo e a extensão.
Prima facie: À primeira vista.
Primus inter pares: O primeiro entre seus semelhantes.
Prior in tempore, potior in jure: Primeiro no tempo, mais forte ou mais poderoso no direito
Privilegium fori: Privilégio de foro.
Privilegium imunitatis: Privilégio da imunidade.
Pro derelicto: Em completo abandono, em desamparo.
Pro domo sua: Em seu próprio benefício.
Pro forma: Por mera formalidade.
Pro labore: Pelo trabalho.
Pro rata: Em proporção.
Pro re nata: Conforme as circunstâncias.
Pro soluto: A título de pagamento, para valer como pagamento.
Pro solvendo: Destinado ao pagamento. Para pagar, para solver um dívida.
Pro tempore: Temporariamente, segundo as circunstâncias.
Probatio incumbit asserenti: A prova cabe a quem afirma.
Probatio incumbit neganti: A prova cabe a quem nega.
Producta sceleris: Produtos do crime.
Pronuntiatio judicis: Sentença judicial.
Proprio nomine: Em seu próprio nome.
Proprio sensu: Em sentido próprio.
Propter officium: Em razão do cargo.
Punctum pruriens judicii: Ponto incômodo do juízo, contestação.
Punctum saliens: Ponto saliente, ponto principal.
Quaestio facti: Questão de fato.
Quaestio juris: Questão de direito.
Quantum: Quantia (em pecúnia pedido em condenação).
Quantum debeatur: O quanto se deve.
Quantum satis: O quanto suficiente.
Qui actum habet, iter habet: Quem tem o direito de conduzir, tem o caminho.
Qui inde?: Onde o Direito? Qual a solução do Direito?.
Qui medium vult, finem vult: Quem quer o meio, quer o fim.
Qui pro quo: Uma coisa por outra.
Qui prodest?: A que isto serviu? A quem isto aproveitou?.
Qui suo jure utitur neminem laedit: Quem exerce o seu direito a ninguém prejudica.
Qui tacit, consentire videtur: Quem cala consente.
Qui transigit, recte alienat: Quem transgride de fato aliena.
Quid novi?: Que há de novo? Quais as novidades?.
Quid prodest?: Para que serve?.
Quo capita, tot sententiae: Tantas cabeças, tantas sentenças.
Quo plerumque fit: Aquilo que geralmente acontece. É lícito admitir o fato singular somente quando provado.
Quod abundant non nocet: O que é demais não prejudica. O excesso de clareza não prejudica.
Quod nimium est laedit: O que é excessivo prejudica.
Quod nonest in actis non est in mundo: O que não se acha no processo, e conforme a disciplina processual, não existe. Aquilo que não se exterioriza em um ato, é abstrato, não sendo, portanto, deste mundo.
Quorum: Número mínimo para funcionamento de um órgão colegiado.
Repere in jus: Levar a justiça.
Ratio agendi: O motivo determinante de ação de agir em juízo. Razão de agir.
Ratio decidendi: Razão de decidir.
Ratio essendi: Razão de ser.
Ratio fori: Em razão do foro.
Ratio legis: Em razão da lei.
Ratione auctoritatis: Em razão da autoridade.
Ratione contractus: Em razão do contrato.
Ratione fori: Em razão do foro.
Ratione legis: Em razão da lei.
Ratione loci: Em razão do domicílio, do lugar.
Ratione materiae: Em razão da matéria.
Ratione officii: Em razão do cargo, do ofício.
Ratione personae: Em razão da pessoa.
Ratione temporis: Em razão do tempo.
Rebus in stantibus: Estando assim as coisas (cláusula).
Rebus sic stantibus: Assim estando as coisas, permanecendo assim as coisas.
Reformatio in pejus: Reforma para pior. Não é admissível que, ao julgar o recurso, o Tribunal piore a condenação do recorrente, sem ter ocorrido recurso da parte contrária.
Rei sitae: Onde a coisa se encontra.
Rem gerere: Administrar seus bens.
Remedium juris: Remédio do direito.
Repetita juvant: Coisas repetidas ajudam.
Res: Coisa.
Res adversae: Coisa adversa, infortúnio.
Res amissa: Coisa perdida.
Res de que agitur: A coisa de que se trata.
Res derelictae: Coisa abandonada, sem dono.
Res familiaris: Bens de família.
Res furtiva: Coisa objeto do furto.
Res in judicio deducta: Coisa deduzida em juízo.
Res inter alios: Coisa entre terceiros.
Res inter alios acta, allis nec prodest nec nocet: Os atos dos contratantes não aproveitam nem prejudicam a terceiros.
Res judicata: Coisa julgada.
Res judicata pro veritate habetur: Tem-se por verdade a coisa julgada.
Res non verba: Atos, não palavras.
Res nullius: Coisa de ninguém.
Res petita: Coisa pedida.
Res publica: Coisa pública.
Restitutio in integrum: Restituição por inteiro, recuperação no estado original da coisa.
Reus sacra res est: O réu é coisa sagrada.
Rigori aequitas praeferenda est: Deve-se preferir a eqüidade ao rigor.
Rogatio legis: Propositura da lei.
Sedundum legem: De acordo com a lei. Espécie de costume que consiste em regras sobre a uniforme interpretação e aplicação da lei.
Semper et ubique unum jus: Direito é o mesmo sempre e em toda parte.
Sententia contra jus constitutum lata: Sentença proferida contra direito constituído.
Sententia contra sententiam nulla est: Sentença contra sentença é nula.
Sententia est: Esta é a senteça.
Sententia facit de albo nigrum de quadrato rotundum: A sentença faz do branco preto e do quadrado redondo.
Sententia quae in rem judicatam transit, pro veritate habetur: A sentença transitada em julgado, tem-se por verdade.
Servatis servandis: Conservando-se o que deve ser conservado.
Si et in quantum: Agora e enquanto perdurar a mesma situação.
Si virgula cadit, actio nequit: Se faltar a vírgula, perde-se a ação.
Sic: Assim, tal. Vocábulo consignado entre parênteses, para indicar que a referência está feita como no original, ainda que errônea ou singular.
Simili modo: Do mesmo modo.
Simili ratione: Da mesma razão.
Simplex veritas: Verdade pura.
Simpliciter: Simplesmente.
Sine capite fabula: História sem pé nem cabeça.
Sine cura: Sem preocupações.
Sine die: Sem fixar dia certo.
Sine qua non: Sem o que não.
Societas criminis: A sociedade do crime.
Societas delinquere non potest: A sociedade não pode delinqüir.
Solo animo: Única intenção.
Solutio indebiti: Pagamento indevido.
Solutione tantum: Somente pelo pagamento.
Solutus a vinculo: Livre de vínculo.
Solve et repete: Paga e reclama. Obrigação de pagar para poder reclamar, aplicado no Direito Fiscal.
Specialia derogant generali: As coisas especiais derrogam as gerais.
Sponte sua: Espontaneamente, por vontade própria.
Statu quo (ante): No estado em que se encontrava anteriormente.
Status: Posição.
Status libertatis: Estado de liberdade.
Stipendium: Salário, tributo.
Stricto jure: De direito estrito, aquilo que deve ser feito dentro da rigorosa expressão da lei.
Stricto sensu: Em sentido estrito.
Sub censura: Debaixo de censura, sujeito à crítica de outrem.
Sub conditione: Sob condição.
Sub examine: Sob exame.
Sub hasta vendere: Vender em leilão público.
Sub judice: Em juízo.
Sub lege libertas: A liberdade sob a égide da lei.
Subjectum juris: Sujeito de direito.
Sublata causa, tollitur effectus: Suprimida a causa, cessa o efeito.
Substractum: A essência, o princípio da coisa.
Sufficit: É bastante, basta.
Sui generis: Especial, único.
Sui juris: Pessoa capaz.
Summa imperii: O poder supremo.
Summum jus, summa injuria: Suma justiça, sua injúria. Exercício do direito em excesso gera injúria excessiva.
Superavit: O que sobra.
Supra summun: O mais alto grau.
Suum cuique: A cada um o que é seu.
Tabula rasa: Tábua lisa onde nada foi escrito. Em linguagem literária, significa que nada foi dito.
Tantum consumptum, tantum judicatum: Tanto se consumou quanto se julgou.
Tantum devolutum, quantum appellatum: Devolvido tanto quanto apelado. Princípio segundo o qual o reexame na instância ad quem prende-se aos pontos objetos do recurso.
Tantundem: O mesmo.
Tempus est optimus judex rerum omnium: O tempo é o melhor juiz de todas as coisas.
Tempus regit actum: O tempo rege o ato.
Tentare non nocet: Tentar não prejudica.
Terminus a quo: Ponto de partida. Termo a partir do qual.
Terminus ad quem: Ponto de chegada. Limite ou termo até o qual.
Tertio: Em terceiro.
Tertius: O terceiro.
Testis, unus, testis nullus: Uma testemunha, nenhuma testemunha.
Thema decidendum: Tema a decidir.
Timeo hominem unius libri: Temo o homem de um só livro.
Tollitur quaestio: Suprimida a questão.
Traditio longa manu: Tradição de coisa ao alcance da mão.
Transigere est alienare: Transigir é alienar.
Tributum: Tributo.
Turbatio sanguinis: Mistura de sangue.
Turpis causa: Causa torpe.
Ubi eadem est ratio, ibi ide jus: A mesma razão autoriza o mesmo direito.
Ultima ratio: A última razão, último argumento.
Ultimatum: Ultimato (últimas propostas).
Ultra modum, sine causa: Além dos limites, sem motivos.
Ultra petita: Além do pedido. Sentença que concedeu mais do que o pedido na inicial.
Ultra posse, nemo obligatur: Ninguém é obrigado além do que pode.
Una voce: Com uma voz, unanimemente.
Unicuique suum: O seu, a seu dono; a cada um o seu.
Uno consensu: Com unanimidade de votos.
Unu et idem: Um só e mesma coisa.
Urbi et orbi: Na cidade e no campo.
Urbs: Cidade, habitantes de uma cidade.
Usque: Até.
Usque ad finem: Até o fim.
Usque ad terminum: Até o limite.
Usus forensis: Os usos do foro, praxe.
Usus fori: Uso do foro.
Ut: Como, posto que, de maneira que, assim como.
Ut fama est: Como é fama, segundo consta.
Ut fit: Como abaixo (está escrito).
Ut puto: Segundo creio.
Ut retro: Como atrás.
Ut rogas: Como solicitas.
Ut supra: Como acima.
Uti non abuti: Usar, não abusar.
Uti possidetis: Como possuis agora (é o princípio que prestigia a posição do possuidor efetivo de um espaço territorial contestado).
Utile per inutile non vitiatur: O útil não é viciado pelo inútil.
Vacantia legis: Vacância da lei.
Vacatio legis: Dispensa da lei. Espaço de tempo entre a publicação de uma lei e a sua entrada em vigor.
Vade mecum: Vem comigo, livro para consulta rápida.
Vana est sine viribus ira: Vã é a ira sem a força.
Vani timoris iusta excusatio non est: A escusa do vão temor não é justa.
Vectigalia decoquunt: As rendas esgotam-se.
Venditio ad corpus: Venda conforme a coisa.
Venditio ad mensuram: Venda de acordo com a medida.
Verba legis: Palavra da lei.
Verba mollia et efficacia: Palavras suaves e eficazes.
Verbatin: Palavra por palavra.
Verbi gratia (v.g.): Por exemplo. O mesmo que exempli gratia (e.g.).
Verbis: Textual.
Verbis tantum: Somente com palavras.
Verbo ad verbum: Palavra por palavra.
Verbum pro verbo: Palavra por palavra.
Veredictum: Veredicto. Declaração dos jurados sobre a culpabilidade ou não do acusado.
Veritas evidens non probanda: A verdade evidente não precisa de prova.
Veritas odium parit: A verdade gera o ódio.
Versus: Contra.
Verus dominus: Verdadeiro dono.
Vetustas vicem legis obtinet: Os velhos costumes transformam-se em lei.
Vexata quaestio: Questão levada de lá para cá, por isso batida, agitada, tormentosa. Questão controvertida.
Via crucis: Caminho da cruz.
Vide: Veja, confira.
Videbimus infra: Veremos abaixo, depois.
Vim, clam et precaria: Posse violenta, clandestina e precária.
Vim vi repellere licet: É lícito reprimir a força com a força.
Vinculum juris: Vínculo jurídico.
Vinum memoriae mors: O vinho mata a memória.
Virgo intacta: Virgem.
Virtus est in medio: A virtude está no meio-termo.
Virtus probandi: A força da prova.
Vis: Violência.
Vis absoluta: Violência física.
Vis adjuvat aequum: A força protege a justiça.
Vis attractiva: Força atrativa.
Vis compulsiva (=vis impulsiva): Violência moral.
Vis corporalis: Violência física.
Vis jus contra juris vim: O direito da força contra a força do direito.
Vis minima: Lei do menor esforço.
Vita anteacta: Vida pregressa.
Vitae curriculum breve: A curta carreira da vida.
Viventi nulla hereditas: A herança de quem está vivo é nula.
Volenti nihil difficile: Ao que quer nada é difícil.
Volenti non fit injuria: A quem consente não é feita injúria.
Voluntas legis: A vontade da lei.
Voluntas sceleris: Resolução criminosa.
Vox unius, vox nullius: Voz de um, voz de nenhum.
Vulnera non dantur ad mensuram: As lesões corporais não são praticadas sob medida.
citando governando repreendendo obe deciam prescries taboca extremidades vigoro conduzia panhamento ilumi nando cortejo archote alcatroado erguia voar pedrinhas dando-se observncia confortador provrbio diretamente fatigado especial fulguran estalos destacados crvel enfei tiado passageiras sentira cupado precipitaes raciocinando antegosto vvel defun prevenidas acontecimento enterro mandaram cher fazerem armador lou-se desenhista tomou-se encomendou-se vestimenta resolveu-se conceio vistosa ofereceu-se prontamente encomendla malcosida sairia valer ladroeira descarada enriquecem armadores gatunos cetim escumilha fil franjado teimavam negavam considerando exemplos pulquria senta ramo vermelhas chiquinha vasconcelos aberto ao as ar de da es em do ca en co at me na ou no os ps so to um se ti pe va ma te po ia le mu ir ai qu vi lo av ru ga ro si sa ah pr oh al vs hu vo mo rm re ds ns ra gs la sr dr fi ha xe eu ms ne mi zs tu su ta in ba nh om ig ui cu bm di nu tm du ho am er ex fa go ii im ss ch an et ge bo pi ri ban caa das cal bem cer ces der iam dez dia lam nas aos ler ele dor nem foi boi era cul ter tem ser seu res com por lho lus uma sol tom voz que rua sua mor mar nos cos exa luz ali vam dos tra uns mas vez sim plo sem ver rio ela arm ano tal ana con teu sob pes bra sil lhe meu bom boa vir avs joo gus jos fez des moa ini moo vin ras ama deu pai mau cor tos cas les apa her lua trs par vlo for acar mam alm cada dade mui flo cedo caiu dias amar cido lado cala nada bela brao acre nham sabo lhes nico alma rede refi rico sair pies pela cujo vida pode obra pelo ento peso como dgua todo para tudo praa rins nuas pele sujo guin toda viva sons hora pale brim sova suor esta casa preo taxa numa gria alta ples baru cera teto mais suas onde duas pavo alto seus idia mesa loua quin chil sabi dava anjo boas rosa este fala anos nome quem qual fora seis essa poca vivo gran vara ares porm logo stio neta mato cabea muda arre dera seda emol ceder fgado balco calas chiam bocas cames casas cheio deles cmbio chapu sadas ganho calor gemer clice pelas filho faria marca maior mudar divel homem corao fatos negra crava podia sebre desta velha paixo valor pobre tsica papel prata potes autor quase preta lista livro resta ptria nuvem muito suado verme uivos porta longe arroz terra sobre outro praia santo todas tetas resto pardo plena coxas vigor valos entre portu tavam muita manha gente canta feira tinha olhos punho milho vezes batia posto tanto geral ricos gados larga forro ripas menos cabeas vista abria longo cachaa tinta cujas velho gosto cidade bandas canto caixa pinho cheias prato horas tarde ainda afinal almoo vinho vinha encher mangas armado branco cantar chavam direes folhas faziam pedras camisa jantar carter diante fnebre janela adorme mexiam cotejo pernas gentil polida humano moscas desvio mulher certos prdios irreme sgnios imenso seboso sentir mulato estava trazer sangue levado crueza natura europa pretos tortas rvores sombra pontos enorme tinham veneza vazias cheiro antnio buzina negras gordas grande porque aquela homens rubros negros servio dentes ombros pilhas caixes guesas algodo tarifa pode-se gneros outros vogais diziam mil-ris leiles corria quente zunzum piscos trgico quando ocasio caladas muitas viam-se proteo chalaas bigode suadas vadios manuel telhas bacanga rtulas mingua repeti alguns afetado cebolas falando manchas polido limpas andavam descalo debaixo crianas batatas chegava paredes nascido criaram amarras parecia alegria maranho sociais formado vidraas carroas vergada madeira gemidos azevedo falsete coberto compras corriam mordiam carreto enormes destino humanos quadris todavia pessoas preguia estavam espduas estrela grandes minavam comprar armazns fizesse negcios somente perdiam amizade queriam martelo costume erguido grossos furador farinha fazenda repetia cantado trmulos mal-rais fingida ociosos prprios varanda sobrado pescada caibros aspecto pitores quintal tristes pintado lugares traziam tratado expondo pratas moderno dormia abafadio mquina ts-sacos costura wilson portas quatro estudos julien estaes relgio abalando ouvia-se pndula tamanho aponta servira garrafa branca chegaram restos barradas lisboa cavalgar chegavam jacarand gaiola janelas desse pareciam ganhavam abdomens ilhargas embalava reava fazia invadiam deixando confiana apregoar alegasse pintadas descobre cobertas estar pantaleo entregar naquelas realizar carolina maternas crestada vendidos portadas transaes passavam raimundo virilhas namentos escravos querendo biqueira esquinas trocando moleques paneiros gritando retornar miservel deslizar risinhos espertas hamburgo instante desempre prontido curiosos estreito mirravam passeava azulejos instruda montonos desenhos mostrava assuntos suportar surradas defronte corrente obstante virao ambiente morno aprazvel havia quietao inteis vontade lassa fechar esticar margens baseou-se opostas vegetao guarda provocar sestas capim abrir braos chamando tepidez sombras disse cadeira achava beceira frente filha ouviam-se sabes trario dilatadas claridade desejo primeiro lugar convm banheiras saber sociedade afogueado faiscavam acocorado vamos embebida aflautada diamantes papagaios mocajubas comercial espalmado rebolando cochilava esbofados nacionais crescidos empinando gotejando atividade diligncia dominando arrastado assentado caixeiros apregoava perninhas irascveis tabuleiro quitandas peixeiras abrimento leiloeiro esbrocava esquecida primeiras cintilava respondes correntes casamento avultavam resolviam perguntas comprovao opulentas respondeu rolar ponta dedos interesse grosseiro movimento mostravam continuou migalhas toalha pedro silva conhecido portugus cinqenta forte vermelho diziam-no atilado comrcio amigo gostava leitura mosquitos descanso assinava volumosos jornais srios provncia recebia pequeno vrios trechos poetas prezava fanatismo marqus pombal sabia anedotas gabinete perdida romance casado senhora arregaadas alcntara chamada mariana liberdades virtuosa melhor parte extremada religio morreu deixou escaldavam legado nossa carmo ascendncia melanclico triste aborrecido orfanada precisava amparo embarrilar maternal aguadeiros anunciando joelheiras apressadas entranhado vendedeira pescadores escarlates porcelanas permanecia aguardente mangueiras cor-de-rosa convergiam estendidos arrastando acostumado litografia refrescava leiloeiros esconderam coitadinha nesse fermentava silenciosa tempo moravam caminho invariveis exuberante mosqueados encontrava imponentes estridente municativa batiam-lhes corretores intervalos casinha trrea molstia assinatura justamente estivessem busca movimentos faziam-lhes benignos negociante armazm dou-se pequena lojas prosperava fazendas atacado ficar vidou sogra meteram-lhe maria brbara verde-paris abandonar guarda-loua vivia morar menina algum guiasse conduzisse nunca servir essas coisas fosse aprumava-se meter acariciando preceptora jesus diriam falava-se decidisse deixar teria arrepender prpria cruzavam-se quarto liberdade aceitou tantos alojar-se genro batalho crias trabalhador necessidade cacarus amendoeiras chapu-de-sol mercadorias funto marido breve pendido dependurada passo apesar piedosa desesperada concentrado comicamente reverberaes aparentavam maranhenses penteada faltar amarelentos nenhum cachinhos durava preconceito entorpecida encontrando rosto enrugado macilento fervor igreja missas papava quitandeiro intolerncia envernizado apresentava solenemente isso sara-lhe dona fria vbora atravessava aproveitava hbito falava gritar punha morrinhenta naturalista ralhar deus acuda incomodava vizinhana verdadeiro sustentavam tipo velhas criadas tratava portugueses todos musculatura orgulhosa cheia escrpulos sem-cerimnia descabeladas esticando-se dizia sujos referia insuportvel cabra sempre assim discutiam-se devota outra tivera capela santa monstruosos obrigava escravatura rezar noites coro abertos algemados lembrava-se brancacentas suspiros hiplito fino azuis cabelos louros brasileiro avermelhadas adotivo chegou fazer alguma posio oficial comendadores secretaria governo coronel admirao pelos entusiasmo limites preferia-os brasileiros pedida pedroso capital dissera capitalistas tenho certeza compreendeu esposa amado irremediveis enferrujados dedicava-lhes virtude pitangueiras talvez maternidade apenas conseguiu entusiasmado companheira reverberante principiante fiel viveu exclu sivamente contrastavam desgraada desde peitosamente quinze ruidosamente amor eleito pertencer esse existe simplesmente hoje histria agitador cndido moraes popularmente farol possvel protagonista casar ventrezinhos foram baldados esforos irresponsvel perseguies polticas atribularam curta existncia daquela fenomenal criatura tambm inflexvel oposio encontrou famlia rapariga entretanto dela prendido sorte venturado maranhense diria cida criada sertes norte sentiria qualquer capitais mgica influncia superi ores exercem esprito feminino amou-o sentira-lhe dominadora olhar mpetos revolu cionrios americano herosmo patritico superior meio floresceu decora ra-lhe frases apaixonadas vibrantes arrebatamento indignao fulminava exploradores estremecida migos integridade nacional soubesse explicar arrebatou-a belo destemido ardor remdios arrabalde desditoso heri pouco deterministas cinco representando idade sucumbiu jugo prprio talento honra poltica oculto foragido misria odia assassino adorado deixou-se possuir tristeza enfraquecendo ficando doente feia morrer poucos depois conhecer segredo ensinara-lhe compreender respeitar mria talentoso revolucionrio guerra aglomeravam-se desper tava raiva antiga motim agosto minha disse-lhe infeliz vsperas morte consintas casem ames deve destinado cases lembra-te conseqncia inclinaes irresistveis casou fizeres digo sers feliz concluiu pedindo-lhe prometesse caso essem constrangla aceitar contra arrostar evitar semelhante desgraa gostasse cometesse maiores sacrifcios arriscasse nisso consistia lancolicamente verdadeira honestidade conselhos criana procurou compreendlos ligados eles acudia memria palavras moribunda desses alheados sutilezas sentimento daria excelente esposo cuja significativos sensibilidade romntica comover importun experimentando achou principalmente sentiu despeito natural bondade certo desgosto ausncia panheira habituado contudo pensou tornar convencido afeto chegaria sobra amenizar canseiras trabalho auxlio imediato bastaria garantir decncia regra despesas domsticas cresceu pois desvelos insu ficientes gnio aprendera gramtica sotero reis lera coisa dimentos francs tocava modinhas sentimentais violo piano estpida intuio perfeita revistavam-lhes modo bonito lamentara conhecia muitos trabalhos agulha bordava poucas dispunha gargantazinha contralto vrias vernica procisses quaresma cnegos bavam-lhe individualidade simetrizavam-se metal davam-lhe cartuchos amndoas mendubim enfeitados pinturas caractersticas feitas goma-arbica tintas botica nessas ocasies sentia-se radiante impossibilidade faces carminadas coberta cachos artificiais roda vestido curto jeito danarina concha ufana ouro trmulas asas papelo silenciosamente escumillha caminhava triunfante cordo irmandades religiosas segurando extremidade leno segurava isto eram promessas enfermidade crescera bonita formas castanhos puxara rijezas corpo fortes aproximao puberdade receram-lhe caprichos romnticos fantasias poticas passeios luar serenatas arranjou quar estudo bibliotecazinha mancistas paulo virgnia biscuit estante escondido detrs espelho retrato dara graziela lamartine chorou antes ador mecer procurava instintivamente imitar sorriso inocncia procitana oferecia amante praticava pobres adorava passarinhos matar perto borboleta bocadinho supersticiosa queria chinelas emborcadas aparava durante crescente acreditasse justificava-se cmoda estampa litogrfica colorida rezava-lhe dormir disparatadamente agradvel passeio cutim soube projetava linha bondes teve satisfao violenta nervo feitos comeou desco brir estranhas mudanas percebeu trans formao importante operava terrores infundados acometiam-na tristezas motivo justificvel acordou preocupa assentou-se cismar surpresa reparou membros ultimamente arredondado notou curva suplantara reta completamente veio-lhe sobressalto contentamento entristecer bastava barbara afeio siva lembrou-se namoros riu-se doze namorara estudante liceu haviam conversado sala supunham-se deveras apaixonados seguiu escola central corte nele marinha ficava farda engraado vestir-se principiar bordar ofere terminado bandoleiro desaparecido sobressaltavam-na corveta baiana seguiu-se empre gado rapaz cuidadoso roupa unhas parecia-lhe metdi escolhendo pedir subida danar quadrilha tempos pensar semelhantes tolices agora convinha lega dono pudesse abertamente obedecer escrava dar-se dedicar-se sentia absoluta competncia reconhecia tomar conta educar filhos estes devaneios acudia-lhe arrepiozinho febre excitada idealizando corajo capaz matar-se sonhos agitados debuxava-se vulto confuso cantador galgava precipcios chegar merecer-lhe ventura doce esperana samento sonhava noivado banquete esplndido junto alcance lbios mancebo apaixonado moso conjunto graa ternura ardia impacincia devorava-a fogo via-se pensando sonhava-se dependente priso ninho mnio carinhoso umas criancinhas louras ternas balbuciando engraadas comovedoras chaman do-lhe devia mulheres admitir celibato passava viveria outras distraes futuro poderia ambicionar legtimo prazer materni companhia alegre esses binhos feiticeiros gostara pedira lhas mandasse fazer-lhe enquanto pilhava ningum incomodasse elas dar-lhes comida lavlas vesti-las acalentlas constantemente talhar camisinhas fraldas toucas sapatinhos pacincia pequenina bonecas amigas casava exigia cravo ramalhete boto laranjeira grinalda aquele pregava-os samente seio alfinetes dourados noiva quedava-se fitlos cismando partia suspiro viajante sente cansado avista lar noivo andava ardente apresen decerto entanto amava dizlo vibrar-lhe fibra ntimo desconhecido saa pensamento gum enchia lgrimas passaram-se meses correram principiou emagrecer visivelmente plida mal pratos incomodado doentio pareces mesma anica sobressaltava-se cometido falta cansao nervos valesse pena chorava olha temos choro preciso cha mdico chamar ora papai vale tossia deixassem paz apoquentando sufocada ests achacada levas chrum precisa molstias brinca receitou banhos dareia delicioso pas sou costa choque longos restituram-lhe apetite enriqueceram-lhe ficou engordar travara nova eufrasinha quinto infantaria paraguai requebrando-se poetizava-lhe casados seguira campo batalha denodo coragem atravessado bala artilharia rendo balbuciar lbio ensangentado feito desejos satisfeitos conclua pesarosa prazeres nesta conhecera compadecia-se amiga escutava-lhe frioleiras ingnua comovida sinceridade facil mente identificava singular daquele simptico chorar instruiu ensinou-lhe mistrios jugal dizer-se lies falou esperta lidar quais manhas fracos maridos namora tipos preferveis significava mortos beios nariz comprido ria-se tomava srio aquelas bobagens intimamente dar reconstruindo ideal instrues espiritual mano verossmil suscetvel descoberto debuxado fundo veio acentuou-se figura recebesse timos toques pintor correto emen dado pronto quanto amaria efeito realidade partir emendado base deliberaes respeito bitola aferia requestasse pretendente tivesse gesto enfim consta padro perder cair graas mudou-se visitaram-se estas visitas tornaram ntimas repetidas serviram mutuamente consolo afincado precoce viuvez empregado ativo econmico discreto letra estimado contavam favor invejveis partidas tino comer cial seria dizer contrrio falavam dele coi tado coitado inteiramente razo faltava lavada engomada cima cobres emprego diabo prspe circunstncias impunha certa lstima impressionava eterno piedade splica resignao humildade incutia visse submisso passi besta carga levantaria experimentar repugnn cia covardia elogiavam-no fossem atrs modesto truz negociantes ofereceram-lhe vantagens tomlo humilde baixa resistia-lhes firme constncia ops propostas dando mento patro elogiou escolha profetizou nubentes acertado fito via naquela trabalha dora passiva usurrio felicidade queria-o scio colegas retirava quarta ordenado peclio considerava quisesse levava foi-se habituando julglo estimlo distingi-lo tinha-lhe birra sofrer cabelo escovinha cavanhaque aqueles economia torpe somtico classificava franzindo tocou-lhe perguntou espantada soltou risada animou palavra noite contou particular compadre cnego diogo optima soep despecta sentenciou deixe correr barco alterara esperava calado pacifi camente erguer signao pedia resposta definitiva estada fitar procurasse resoluo cantava sequer ergueu-se quero passou volta cintura rapari disposto conversar interrompido passadas corredor licena entrando entrou devagar amvel sessenta conservado teso ungido brandura santarrona calava-se mero polimento mandava buscar uso meias colarinhos especiais ria lim pos chumbados distintos mos brancas alvos confidente conselheiro pesado consultar mara-se coimbra donde contava maravilhas relaxava descarregar explicava rir beijar trabalhado anel ametista porto feita encomenda batendo-lhe face fina impregnada sabonete ingls afilhada vai bizarria agradecida sorriu dindinho est notcias babita sossegada interrogou missa naturalmente almoou conserve milagre trouxe negcio comunicar bocado meno afastar-se deixa-te aqui escritrio dois compadres conversando encami nharam-se saleta cho esteirado forradas travessinhas paparaba cartei escrita mocho inclinado cofre ferro pilha livros escriturao mercantil prensa copiador copo bordas descansava pincel chato cabo largo palhinha caixo papis bico escarradeiras parede secretria calend semana ambos algibeiras pejadas notas recibos chamava pamposamente correspondncia entregava interesses especulaes podiam maniazinha querer especular desvirtuava melhores intenes entraram fechando discretamente esparralhava levantando canela batina lustrosa talho tomado cigarro amarelo carteira acendia-o sofregamente notcia suspensa espantado boca aberta tronco espalmadas joelhos erguida sobrancelhas atravs cristal culos sabe quan viu instalado sorveu pitada mundico sobrinho aque domingas sei espera padre tirou algibeira rebuscou carta peixoto deveria vapor sul armou leu seguinte datada janeiro revmo melo folgamos encontrar revma gozo sade fim reverendssima paquete segue encarre gou achvamos estabelecidos declarar competente houvssemos envidamos conseguir nosso recomendado ficasse visto conseguirmos tomamos remet formar-se teologia igualmente realizou curso preparatrio escolheu carreira direito acha distines bonitas cumpre-nos apreciado lentes condiscpulos portugal alemanha segundo diz tencionava fundar empresa estabelecer-se deseja efetuar nessa venda terras pro priedades dispe escrevemos novamente prestamos contas zemos seguiam-se cumprimentos estilo terminada chamou benedito leque ordenou-lhe chegado moleque voltou pou dizendo senhor correio exclamou encaminhado quer liquidar estabelecer soprou falemos brasil grandssima asneira tinuou abaixando ignora bio grafia sabem saiu viesse manda aviar levantar novo demais fazendo enchendo ruas gastando coisinha roer moradas punhado aes jimbo comanditrio rosrio tapera observou fer rou num ponto perceber miniscncia dominava acreditam almas doutro mundo prosseguiu nuel consegui dar-lhe olhe cana preocupado lembrana acrescentou despertou deixe-se disso retrucou levantando-se mpeto venha esto vendo supe riores nossas cozinheiras jei inchava medida sria proibir cabras misteres conheam transformava-se parece pirraa bradou nascer mole condies deste esmurrando-a contar-se inteligente deviam burros pres tassem mesmo malditos voc diga asneiras confessada casada negro beijasse netos nhassem palmatoadas professor bati tolo abaixou derrotado respingava sacerdote ltimas gotas aguaceiro vivamente exten atirando ndia stultorum honor inglorius nisto bateram adiantava sando posso achar dei entrar cancela te-a vinham-lhe devo receblo qualidade bastardo claro cabeadas homessa fica verdade hospedlo obrigaes defunto poderiam boquejar hospedasse pausa rapazes omnem aditum malis prejudica hospedo meus fregueses interior diferente moram comigo impacientando-se moscas-mortas sabemos doutor melro vem paris mitrado esteja intumescia papada experimenta arriscou sopeando medo dis desagradar fineza dever interrompeu tomando atitude principiado tornou nimo obrigao moer-me nhonh pchio cortando conversa hos pede revestindo pachorrento estu santarro chegarem trajes debruada parapeito derramando incerte zas resolveste caprichosa contemplava risinho orgulho realmente alvo fusto ale gre cheirando jasmins gaveta itlia emoldurando oval fresco castanho farto sedoso aparecia bands reaparecia pescoo enrodilhado despre tensiosamente tinhas dito ias vestir vou bateu ombro meto-lhe inveja hein diacho faceira insultes miseris interjeicionou olhando lgio meia tratar despacho apressado benedi levasse gua morna banhar rica freitas lembra lindoca faz cspite peru forno vossemec aparea dana hum-hum creio sur presa filarmnica entretida endireitar folhos sombrinha ouviram-se bater embaixo fechavam rudo fechaduras seguida som passos repetidos escada subiam bento cordeiro trinta arruivado feio barba gabava-se prtica chamavam alho encomendas metia bolso capurreiro sabido empregados antigo lograra continuava dio surdo patife disfar ava constante defeito depunha raposas entrada soci edade trabalhava queda domingos metia-se tiorga atravessou silencioso cortejando afe tada rante passar gustavo vila moceto dezesseis soberbas cores portuguesas clima conse guido destruir humor lisonjeava-se inquebrantvel haver ficado cama ganhara fama extravagante casimira moda passear mingos bailes familiares contribuio queima charutos vintns assi mrcio biltre peralta procurando bradava-lhe furioso diabos entender gosta amigos gazeta trado pra burro ouvia destas doutras amabilida ganhar cai xeiro conformava-se respingar certas satisfeito brusco cumpri parar sorrir inclinando risota mitra julgou botes escondidas jaqueto gola subia ate nuca sapatos grandemente despropor cionados zuarte dobradas bainha espanta gestos desconfiados rpido conder traa levar pescoes chegara deia chamar-se manuelzinho vermelhos saudades varria limpava balanas burnia pesos lato batiam ponsabilidade queixar divertiam-se custa riam-se repugnncia orelhas escura desfeava-lhe testa cicatriz trambo levou primeira deram desterradozinho haver-se engenhoca companheiros cunha salta-cho punham-lhe nomes feios chamavam-lhe bisca servia chamarem atravessando bicho assustado qua gritou coando trariado pareces-me levanta cachimnia suspendeu-lhe queixo insistia peludo pergun tou-lhe poro enri quecer comenda pssaro guariba encontrara rvore patacas mastigava respostas inarticuladas aflito chamas portuguesinho meneou afirmativamente aper tou conter riso vlvula responde falar mariola voltando-se sonso estado traz tens podes dla confessaste maroto podendo suster abriu caldeira custo refreava cuspir-me vai-te repeliu-o limpou correu menino puxou-o arregaou-lhe jaqueta revistou crescidas sujas censurou desculpe tirando indispensvel tesourinha caixeiro limpar baixinho mes separam coitados devem amargar completa solicitude materno levantou-se encostar-se randa cortar perguntando lembrar-se pasmado levantou carou baixo terrestre vacilar fitou-os sentindo sbito espcie adorao inesperada afigurava-se extraordinrio pobrezito desprezado brasileira limpa vestida perfumada macias esti vesse cortar-lhe assear-lhe princpio sacrifcio horrvel plcio desejava cena incmoda fugir difcil resfolega ousar mexer lados esguelha procura sada escondesse pretexto arrancasse dali aquilo dvida animava respirar livremente receoso notar hlito nhora doam juntas imobilidade contrafeita mexia dedo minuto correr-lhe bagas verdadeiros calafrios penetrante meiguice prprias rebentaram-lhe desceram-lhe silncio cara dessas assistia rufando tabaqueira burnidas cinza charuto desgraadinho provocando-lhe grimas contendo sentido andar gato levando fato acarinhando ralava-o caridade tasse amofinava-o sra voltas peste peque embonecar chichisbu var-lhe cartas desaforo trazer-lhe presentinhos recados pelintras vazas completava pessoal fechado ovo choco denuncia casca podrido bilio sas desprezo taciturnidade paci ente exagerada adivinhava-se-lhe fixa acrobata equilibrasse corda tesa desdenhava depressa fins aceitava examinar parecesse contanto rapidamente desejado lama brasa enriquecer repugnante magro curvado pouca fundos chinelos trana fizera-lhe mons truosos chatos lanava-os desairosamente palmpedes nadando abor recia-o teatro reunies necessrio despender gen azedo roupas conceber ordem porco resumia justa escova respondiam iche tinham-no benfazejo condu exemplar deixava sbados peixe frito mulata gorda morava filhas confins crioulas sozinho troas conhecidos nesses lata marmelada extravagncias votava-lhe dava-lhe guardar ouros economias relao ticular manh aparecera comodado deixasse solcito man dou-lhe porcaria facultativo recomendando nhos mornos preci sava segunda pde dissesse asseio tratamento acabou provando limpeza necess alimentao daqueles transpirar falou-lhe paternal lamentou-o amigveis desa protesto forma sermo costu terrinha cuidado perigosa rigosa fio tratou lembrou comezainas caldeiradas deirozes orelheira feijo aorda caldo gordo famoso bacalhau algarve pescado suspirou saudoso pitu nossos figos comadre castanhas assadas verde escutava comodidades frutas divertimentos terminando contar casos idnticos transpor tou-se rindo bateu-lhe carinhosamente jurou-lhe calhando mtodo casasse importncia digo-lhe sejam compreende pilhria sorrisos inteno cautelosamente visita daquelas ouvissem pisadas deu-lhe conselho estudasse prometeu arranjaria metlo aula noturna letras recomendou-lhe tomasse banho bomba poo faa serei rematou afastan do-o ligeira palmada retirou-se comovido tope traste tremer chamara murro explicou palestra cuidar constar zangado torna lamrias ouvidos arredou-se ticado tremenda desamparado renascer-lhe obscura mgoa desterro continuar viver reunio esteve animada houve vio cantoria deitar chorado bahia meia-noite valsa acometida ataque terceiro felizmente chamado pressa afianou valia passadio despedir-se segredou-lhe sorrindo quiser trate casla vinte chega frios exerccios percebe ignorncia imaginou alimenta ocultamente correspondido sacudiu bros cumprimento ordens inaugurou enferma fresca madrugada hbitos sete novidade misterioso sinal aparecer cruzeiro largou subiu providncias receber hspede ganhou sarem fortaleza marcos salvar tiro tomaram escaler bordo vistas interrogadoras parecido acompanhado comentada vinham barrigas secos molhados barraqueiros espiavam tar taruga cangueiros paravam mirar cara-nova perua-gorda acudiu gajo ruidosa parente ada rapago apresentou grupos sor risos delicadezas apertos nhecemos-lhe chama-se indagou buxo montar afianavam capitalista discutiam-lhe luisinho lngua afirmava casta chegados desfizeram-se cerveja prefere conhaque prepara guaran cerimnias queixava-se suei recolher-se vonta arejar-se bagagem tarda veja penetraram ponha-se precisar agradeceu penhorado mandei afeito qui obrigado repousar descanse almoar afastaram-se cheios tesia afabilidade acabado lustrosos crespos tez morena amulatada claros reluziam negrura estatura elegante fronte espaosa caracterstica fisionomia ramalhudos tanas eriadas plpebras roxo vaporoso mido desenhadas nanquim sobressair frescura epiderme raspada lembrava tons suaves transparentes aquare educados sbrios despidos pre tenso distintamente armar vestia-se seriedade artes cinci literatura povos diversos impresses diferentes tomada jamais conseguira deduo lgica satisfatria procedncia viera agradecer bens va-se sado jurar faltara suprfluo franca pessoa encarregada acompanhlo tutor valha tio chegasse conheclo recordasse vido sabia-o interm correspondente deduzia algumas vagas reminiscncias meninice culpada receosa patentear vergonha perdia-se conjeturas malgrado prendimento passado atralo irresisti velmente descobriria enigma vivera rfo afeies legtimas duradouras perdoar-lhe-ia quinho pertencia intacto entreglo desvendar determinaram nascimen refletia retroces vender abriria trabalharia desejar conclura tudos viajara possua fortu caminhar adeus chegando concluso independen seguro misrias futu vadio maus instintos aspirava estabilidade remanso entregar-se tirar parti estudara frana estados unidos faltava-lhe pr-se idias restauradora nho tpido quebrado viagem perfeitamente conscincia bocejou pr-me bocejo adormeceu tranqilamente norava sabida quantos conheceram parentes nasceu refugi ara corrido grito mata bicudo revoltas enriquecido contrabando frica perseguido malquisto povo exterminado escravas moas prevenisse logrou inclume haveres risco novos dios vizinha tributria sus tentava instigada adotivos naquele abundante transformar condecoraes fumaa fuga fizeram cami existia vapores transportes martimos dependiam vagaro barcas vela remo puxadas igaraps ossos contrabandista restava denominado brs fazendola cultivou caf tabaco abortos chamou-se vigrio freguesia ato batismo receberam alforria acalmavam-se nimos pros perou cercou cui dados relacionou-se criou amizades quitria santiago escravo constitua crime fera cravos sucumbiram relho fome sede supersti inchadas bolos costas lanhadas chicote entoava splicas virgem santssima felizes cemitrio vtimas casara motivos colher brancos ttulo padrinho distinguia crioulo declarou admitia negreiro gritava fula pensa deixarei criar despachar-me despacha reu necessrias segurana voltar gritos horrorosos atraram-no rancho descorooado estendida amarradas nua partes genitais queimadas filhinho possesso ten tando abrala aproximava desviavam dardejlo megera bbada clera praguejava obscenidades vando espasmos flagrantes gemia estorcendo-se desarranjo denunciava sintomas loucura assomo acometeu ordenou recolhessem prodigalizassem cuidados batizara fugiu rsula lgua dizia-se rentado confessor acompanhou irmo entregou-lhe ficaria matricular-se colgio roa descansado car sabendo esperavam apeou-se distncia guardou cavalo conheceram-no faro rosnaram ouviu sussurros vozes conversavam aproximou-se curiosidade encostou ouvido reconhe ceu conversaria quela conteve esperou alerta esperar meteu precipi dentro atirando-se perdera sentidos trmulo traidora apossar estrangulado perplexo tolhido assombro ansioso resfolegar situao dificultava-se recu perando sangue-frio consertou apon firmeza matou-a criminoso cachorro porventura perante leis poder var suposta culpa tentasse fazlo recairia injria consumado sagrada testemunha assassnio inocente fessada facilmente documentarei delito garganta cad aterrado batendo neste arranjar divina ajuda remdio defunta sepultada formalidades civis cunho autoridade ape exijo troca aceita cego morso exclamava cumpriu promessa cadver enterrou-se atriburam maligno metido confirmava boatos pastorar rebanho tido santidade virtudes teologais devotos continua ram lguas bcoros galinhas perus cercados voltavam eixos velhos alforriou propsito reco lher-se descansar lenda ganhando amaldioa capi julgar espalhara-lhe carinha opada expresso conseguia trato fraqueza estmago saburrenta finar-se reumatismo tosse convulsa predisposto anemia escrofulosa sar instinto resiste vence escra desvi carcias anunciou abenoou desesperadas separao nhada carinhosa terna protetoras generosidade julgou-se obrigada fruto nascida premissas pertenceram pupilo agasalho tornou-se fraquinha acordo perdla luta primeiros mia perdido santos devoo recordava agrada resma velava bero filhinha tam trouxera entranhas salvou-se bons servios mdi universidade montpellier jauffret quis facultati not sucumbido congesto cerebral repente saco couro credo luto encanecido desfeito estimava-o aprontou-se recolheu-se lti pregar olho excitado terrveis sucessos apoquentara nervoso deli surgir espectros impressionado acordava ouvia-lhe trpegos vacilantes sentia-lhe abafados vozear frouxo doloroso pen embrulhando-se lenol direo achava-se trinco abriu-a voltou-se assombrado fantasma invadia alcova recuou erguidos terror cado desamparadamente fez-se nes negoci ante pronta zelo escalda-ps apalpan contrados cunhado tisanas mezi nhas lembradas ps-se medicina domstica desfalecido voltava erguer-se ficara prostrado sncope sobreveio-lhe durou gstrica mols tia requeria sossego bulha recomendao abraou-o soluando perfilhou-o pediu tabelio testamento chorando remete-me terminou metessem bastante nheiro tivessem gastar dessem fizeram-no pio rar choravam morto ris delirava apareceu proco pieda abandonava prestava-se vial choramingando vedavam enfermo furta apreciar pensavam-lhe acolhimento achavam-no meigo toso acrescentando adulao remediado fortuna aplicar possui seguia-se longa resenha episdios louvveis citavam-se rasgos abnegao molas criaturas desamparadas perdes ofensas graves vas provas desinteresse verda deiro fazendo-se esperavam-no tardes seres pilhrias glorificar-lhe recomendlo magnfico protetor perguntava disseram-lhe livre perigo restabelecimento pleto aparentemente satis ouvir resmungava descer escadas ter-se-ia admirado fra ses querem despachado velhaco sossegado parquia despediu-se anglicos bnos gritou-lhe patamar esca mdicos aparecem seja vagamente boqueiro demanda salas conversou qualidades precedentes cura convalescia prodigiosamente cercavam-no afagos sejosos esquecer imprudncia fatal supunham convalescente resolveu despei instncias contrrias cunhada vais causa fizesse-a fraca opinio deixla respondia iria dolhos acompanhar-te canoeiros inmeras viagens cabe velas partiu correu-lhe urgia conseguinte demorar-se internar-se beber animais conduo matalotagem familiarizados tais caminhos tomam precauo pajem romantica guia serve guiar estrada afugentar mocambos onas cobras falam moradores infundado serto mocambeiros vivem fugidos formando malfeitores desgraados podem rem fcil lanam-se rapinagem atacam viajantes travando-se verdadeiras guerrilhas ficam comprou paragens quantas recordaes despertavam carnaubeiras solitrias pindovais ermos silenciosos horizontes verdura perse guindo paca veado galope barrancos perigosos pungia-lhe encanto selvagem florestas brasileiras europeu america familiar misteriosas caits verdejantes austera seculares preguiosas amplo peito embalada cheirosa matas sono vigiado negar custar-lhe considerou estacar animal andado cisava ordinrio pousa come contando cmodos especi ais destinados exclusivamente hspedes adventcios alis pernoitara diversas hospitalidade vizi mudava algu receava interrogas preferiu lento seguir escurecendo cigarras estridulavam lamentoso piar rolas aninhavam natureza embuava bocejan anoitecia lentamente comesse bebesse dantes cachimbo trajo encontraria dormira ermo pavoroso cozinha gelada armrios vazios horta murcha leito desconsolo fundas lamentava isolamento maldito perdoasse arrependesse dcil nun existiria matado refletir arrancada religioso esporas dispa vertiginoso sela cadeia contraiu rdeas estacou cavaleiro torceu concheando orelha toada estranha sussurran tes tropel cavalgaduras exalava floresta sentiam-se derradei clari-dades acumular erguia-se brilhando altivez monarca inspeciona domnios prpura ltimo fugia hori zonte rei expulso envergonhado entregue tormentos espetculo maravilhoso crepsculo vero extremo descambava ocaso retocando quentes vigorosos minuciosidade flamengo cercava montes vales orlas esfogueado opunha contraste argentina debuxando horizonte duvidoso perfil conflito boreal luzes migas grupo mal-definido rumoroso agitava-se crescia progressivamente caravana ciganos boiada solido tristonha sombria iam-se tinguindo acentuavam-se mens idades cavalgando magnficos cantavam embalo ntono tocavam viola acalentava modas ensinara gajoa quinzena indolente chimbo vago volpia raparigas melenas lisas escorrendo opulncia sen tavam-se odaliscas volumosas trouxas servi alforje delas colo garupa lenta pesadamente aproxi mava escondeu-se enxotada chefe membrudo barbas fumo cavados sombrios irrequietos vivos ameaava poente jacars piquem sejas bacamarte rouca profunda ancio deitada cingindo-lhe lisa carnuda procu rava mida diminuir-lhe iluminada ltimos raios passando sussurrar perdendo tristonho murmrio perdia ltima rstia vermelha recaiu primitivo baldeava misteriosa clareiras imvel pensativo invencvel bomio abraado mordia-o den agudo vagabundo dinheiro mocidade fmea acarinhava seguia desacompanhado intei ramente esquecido arrancaram associao punha-se lembrar plido votava achava-o anelado terno piedoso sensual religiosa agradar venclas incognoscvel amariam teriam desfrutado comparava-se reconhecia-se inferior matasse repeliu-a escutla agarrava-se-lhe crebro obstinao parasita vieram-lhe reminiscncia saudosa sobressaltos noi vado namoro pareceu apetecvel momento descobria belas aten tara culpado cumprido deveres seriam insuficientes carinhos interrogava opondo-lhe dvidas valiam acusaes defendia-se plicava citava dedica maldita rezingueira acomodava razes surpreendeu-se cra rdea solta fugira superfcie pensamentos repelia empurrando-a imaginao repele vtima mergulhava impulso boiando desferindo basta assanhavam-se-lhe remorsos escondera surgiam suava tremia leve galhos eriava-lhe custava fechou corresse toa galopando orvalho ofegava acossado fantasmas vti convulsos falar-lhe enor gorgolhes infame bater-lhe apresentar-lhe sorrin alvitre propor condio ameaa bru tenho-te quiseres punir-me entrego justia doido aceitei acuou agitou-se ingazeiro detonao varou viram soltas salpicado descobriu delrio beijar-lhe querido amores soluar convulsivamente sbita malvado palmas cantando atribudo enterrado sepultura principiava desmoronar mngua antigos cuida converteu lendas supersties gnero inventaram explicar-lhe abandono insuspeita criteriosa aconselhava fos amaldioadas runas feiticeira campos imi me-da-lua caminheiro descuidado perdesse percorrer rodar andrajos causou abalo ves tiram-no sarja inventrio recebeu coube herana depositou recm-criado banco vncia arrendar escreveu pedindo esclareci mentos informado remeteu custou bondosa separar-se doa amoroso expatriar-se preparado desvelo tro navio comandante lamentava-se horror cava hospedou-o tratou-o meteu-o envergou uniforme freqentou aulas deixavam escuro cosia-se travesseiros gos meninos macaquinho teimoso ressentia-se edu cao trouxeram ridicularizavam-lhe diziam-lhe puxando-lhe blusa tosquiada enfiado rer recreio berrar mandassem apareceram-lhe afigurou palestras panheiros cansavam pedir-lhe informaes selvagens las despidas varado flecha caboclos deu-se parecer-lhe falhava ouvira disseram barbado cobriram dessa per feitamente recolhido busclo ram-no estremunhado sujeito umidade aborrecida calculava produzida recordava-se tamanha lucidez recebido beijos abraos notava afa ocultos assustados ilegal acompanhados divagaes vus miste riosos infncia assombravam-lhe vaga perplexidade permaneceu enleado mesmas preparatrios habilitou-se academia incertezas matriculou-se mudou radicalmente transformou modos golpe terrvel entristeclo adotiva chorou-a amargamente ligava dispersaram-se-lhe mgoas triunfou melanclica produziu sentiu-se meteu-se pndegas stiras ridicularizando professores antipatizados admiradores temes imitasse namorador atirou-se versos lricos cantou metros revolucionrias clubes incendirios aplaudido companhei ros janota gastou amantes compensao jor nais artigo crnica teatral distin guiu-se cincia firmou imputabilidade tudioso discursos acadmicos apreciados elogiaram-lhe tese formou-se preparou malas principal ambio instruir-se abranger quantidade conhecimentos esforo mesquinha toldava aspiraes descendia adquirido esclarecimentos dizia-lhe seco morrido chegada estabelecido atribuio enlouquecer irm mistrio hist vergonhosa atrevesse revelar enjeitado herdeiro limpo ddalo empenho penetrlo reconstruir articular fragmentos dispersos completas lograva recordar-se aniquinha tantas adormecera esteira ouvindo boizinho curral papar nenm aparato visitar palanquim carregado cercada precedida preto encarregado alumi lampio folha oitavado cen demnio zangada implicar pespegava pancada descado castanho-claros triangulares truncados navalha barbaramente luxo senhoras aspirando chei alfazema queimada surgirem recordara nascimento odor inqui eto desorientado davam inh alvoroada grunhido fanhoso gaita preendeu recebera acreditou piamente acudiam exemplo macassar cheiroso perfumava manhs dentre lampies iluminavam querosene dave-marias acendedor descia-o abria-o despejava-lhe aguarrs misturada lcool acendia-lhe pavio guinda va-o adiante iluminao estivesse transformada atraes desconhecida resolvido sacou quantia abraou espanha visitou percorreu inglaterra gem correspondentes demorou-se projetos tabelecer residncia maada instalar-se ido ami confiara parecer fico conhecendo dou pulo amazonas volto descarregada possuo reduzido moe queixar-me beneficiara exercitado invejvel experincia conversava assunto redao jornal lealdade houvesse escrupuloso disposio espe ranas tomou reuniram-se vieram sarmentos penteados feias elogiados tran tan tas convertido preceitos conheciam termo comparao los cnscias popularidade ostentavam objeto admiraes assustadores tama fantsticos afetava bibina sarmento bernardina desembrulhlo martrio penteio botar leo arregalava sacudia juba descreves caada lees compunha-se nervosa grosso receitas trazia variadssima coleo vidros garrafas pcaros guardava cascas ranja rom caroos tuturub patetica abaixo dores chamava-se sobrinhas tratavam mame outrinha sumamente apreensiva entendida doces passara recolhimento anunciao concebera primei tenente espigo exrcito espalhafateiro tados desembainhava durindana palha festa assado resistir trinchante arranca chanfalho esquarteja golpes espada fingindo prendia afiando lmina reluzente tijolo lisonjeado nha-se poeta referia-se dzia acrsticos recitativos inspirava recolhida indigesto guinte ceia praticara prudncia salada inteira pepinos pratinho predileto inconsolvel homenagem comeu legume estendeu-se implacvel maxixes abboras jerimuns maneiras pomba sobrinha etelvina criaturinha magra gelado ossudas frias sensuais podres detestvel lagartixa fazia-se horrivelmente suspirava minutos estropiar formidvel ita liano credores tomara apresentou-se amncia sousellas citar datas aniversrio natalcio inmeros filava-lhes impreterivelmente alheia desejada reservas escndalos caam sozinha passarinhando xale meten morria comuns consolao tida citada servial ativa prestimosa cronicamente jeitara dava-se anjos procisso pintava cosmtico detestava progresso azedume meninas tarefa prali acabavam desmanchavam pulinho maquiavelismo zuc-zuc-zuc sirigaita indecncia jurava aprender instrumento desavergonhadas namorados patifaria serviam janta aprontar acender candeeiros deitar-lhes azeite coloclos palitinho bruxaria caia-se pndega cativeiro andam desca rados sam juro bno madrinha lombo especialidade tor nava adorvel detestada pais torcido recebendo obsqui cortesia baixas grosseiras desbocada basbaques enfeitada lacinhos fita roxa moreninha superabundncia pde-arroz feies nitrato esquerdo desastradamente imitado francesa ex-cantora pulga feitio feijo-preto saracoteava-se novidades levan tando-se segredinho ouvi disfaradamente endireitava penteado nestes olhava
1. the  2. of  3. and  4. a  5. to  6. in  7. is  8. you  9. that  10. it  11. he  12. for  13. was  14. on  15. are  16. as  17. with  18. his  19. they  20. at  21. be  22. this  23. from  24. I  25. have  26. or  27. by  28. one  29. had  30. not  31. but  32. what  33. all  34. were  35. when  36. we  37. there  38. can  39. an  40. your  41. which  42. their  43. said  44. if  45. do  46. will  47. each  48. about  49. how  50. up  51. out  52. them  53. then  54. she  55. many  56. some  57. so  58. these  59. would  60. other  61. into  62. has  63. more  64. her  65. two  66. like  67. him  68. see  69. time  70. could  71. no  72. make  73. than  74. first  75. been  76. its  77. who  78. now  79. people  80. my  81. made  82. over  83. did  84. down  85. only  86. way  87. find  88. use  89. may  90. water  91. long  92. little  93. very  94. after  95. words  96. called  97. just  98. where  99. most  100. know  101. get  102. through  103. back  104. much  105. before  106. go  107. good  108. new  109. write  110. our  111. used  112. me  113. man  114. too  115. any  116. day  117. same  118. right  119. look  120. think  121. also  122. around  123. another  124. came  125. come  126. work  127. three  128. word  129. must  130. because  131. does  132. part  133. even  134. place  135. well  136. such  137. here  138. take  139. why  140. things  141. help  142. put  143. years  144. different  145. away  146. again  147. off  148. went  149. old  150. number  151. great  152. tell  153. men  154. say  155. small  156. every  157. found  158. still  159. between  160. name  161. should  162. Mr.   163. home  164. big  165. give  166. air  167. line  168. set  169. own  170. under  171. read  172. last  173. never  174. us  175. left  176. end  177. along  178. while  179. might  180. next  181. sound  182. below  183. saw  184. something  185. thought  186. both  187. few  188. those  189. always  190. looked  191. show  192. large  193. often  194. together  195. asked  196. house  197. don't  198. world  199. going  200. want  201. school  202. important  203. until  204. 1  205. form  206. food  207. keep  208. children  209. feet  210. land  211. side  212. without  213. boy  214. once  215. animals  216. life  217. enough  218. took  219. sometimes  220. four  221. head  222. above  223. kind  224. began  225. almost  226. live  227. page  228. got  229. earth  230. need  231. far  232. hand  233. high  234. year  235. mother  236. light  237. parts  238. country  239. father  240. let  241. night  242. following  243. 2  244. picture  245. being  246. study  247. second  248. eyes  249. soon  250. times  251. story  252. boys  253. since  254. white  255. days  256. ever  257. paper  258. hard  259. near  260. sentence  261. better  262. best  263. across  264. during  265. today  266. others  267. however  268. sure  269. means  270. knew  271. it's  272. try  273. told  274. young  275. miles  276. sun  277. ways  278. thing  279. whole  280. hear  281. example  282. heard  283. several  284. change  285. answer  286. room  287. sea  288. against  289. top  290. turned  291. 3  292. learn  293. point  294. city  295. play  296. toward  297. five  298. using  299. himself  300. usually  301. money  302. seen  303. didn't  304. car  305. morning  306. given  307. trees  308. I'm  309. body  310. upon  311. family  312. later  313. turn  314. move  315. face  316. door  317. cut  318. done  319. group  320. true  321. half  322. sentences  323. red  324. fish  325. plants  326. living  327. wanted  328. black  329. eat  330. short  331. United States  332. run  333. kinds  334. book  335. gave  336. order  337. open  338. ground  339. lines  340. cold  341. really  342. table  343. remember  344. tree  345. 000  346. course  347. front  348. known  349. American  350. space  351. inside  352. ago  353. making  354. Mrs.   355. early  356. I'll  357. learned  358. brought  359. close  360. nothing  361. though  362. started  363. idea  364. call  365. lived  366. makes  367. became  368. looking  369. add  370. become  371. grow  372. draw  373. yet  374. hands  375. less  376. John  377. wind  378. places  379. behind  380. cannot  381. letter  382. among  383. 4  384. A  385. letters  386. comes  387. able  388. dog  389. shown  390. mean  391. english  392. rest  393. perhaps  394. certain  395. six  396. feel  397. fire  398. ready  399. green  400. yes  401. built  402. special  403. ran  404. full  405. town  406. complete  407. oh  408. person  409. hot  410. anything  411. hold  412. state  413. list  414. stood  415. hundred  416. show  417. ten  418. fast  419. seemed  420. felt  421. kept  422. America  423. notice  424. can't  425. strong  426. voice  427. probably  428. needed  429. birds  430. area  431. horse  432. indians  433. sounds  434. matter  435. stand  436. box  437. start  438. that's  439. class  440. piece  441. slowly  442. surface  443. river  444. numbers  445. common  446. stop  447. am  448. talk  449. quickly  450. whether  451. fine  452. 5  453. round  454. dark  455. girls  456. past  457. ball  458. girl  459. tried  460. road  461. questions  462. blue  463. meaning  464. coming  465. instead  466. either  467. held  468. friends  469. already  470. warm  471. taken  472. gone  473. finally  474. summer  475. understand  476. moon  477. animal  478. mind  479. outside  480. power  481. says  482. problem  483. longer  484. winter  485. indian  486. deep  487. mountains  488. heavy  489. carefully  490. follow  491. beautiful  492. beginning  493. moved  494. everyone  495. leave  496. everything  497. game  498. system  499. bring  500. watch  501. shall  502. dry  503. hours  504. written  505. 10  506. stopped  507. within  508. floor  509. Bill  510. ice  511. ship  512. themselves  513. begin  514. fact  515. third  516. quite  517. carry  518. goes  519. distance  520. although  521. added  522. doing  523. sat  524. pictures  525. possible  526. names  527. heart  528. having  529. writing  530. real  531. simple  532. snow  533. getting  534. rain  535. suddenly  536. easy  537. leaves  538. lay  539. size  540. wild  541. weather  542. mother  543. miss  544. carried  545. pattern  546. sky  547. walked  548. 6  549. main  550. someone  551. ones  552. center  553. named  554. field  555. stay  556. itself  557. worked  558. boat  559. building  560. question  561. wide  562. let's  563. least  564. problem  565. followed  566. books  567. tiny  568. hour  569. B  570. happened  571. foot  572. plant  573. moving  574. care  575. low  576. else  577. gold  578. build  579. glass  580. rock  581. tall  582. covered  583. alone  584. reached  585. bottom  586. walk  587. forms  588. take  589. check  590. reading  591. fall  592. poor  593. map  594. scientists  595. friend  596. o  597. language  598. job  599. points  600. music  601. buy  602. window  603. mark  604. ideas  605. heat  606. grew  607. listen  608. ask  609. changes  610. single  611. french  612. clear  613. Tom  614. energy  615. week  616. explain  617. passed  618. lost  619. spring  620. travel  621. wrote  622. cities  623. farm  624. circle  625. cried  626. whose  627. correct  628. bed  629. working  630. measure  631. straight  632. base  633. mountain  634. caught  635. hair  636. bird  637. per  638. wood  639. running  640. color  641. South  642. groups  643. war  644. members  645. fly  646. yourself  647. decided  648. seem  649. thus  650. legs  651. nearly  652. square  653. England  654. moment  655. North  656. teacher  657. happy  658. changed  659. products  660. C  661. bright  662. sent  663. present  664. plan  665. rather  666. length  667. look  668. speed  669. machine  670. information  671. except  672. figure  673. you're  674. minutes  675. free  676. fell  677. suppose  678. natural  679. ocean  680. government  681. lives  682. trying  683. horses  684. The  685. s  686. baby  687. taking  688. grass  689. plane  690. pieces  691. sides  692. pulled  693. 8  694. inches  695. street  696. George  697. couldn't  698. reason  699. difference  700. tells  701. maybe  702. larger  703. history  704. mouth  705. middle  706. step  707. thousands  708. steps  709. cars  710. child  711. opened  712. thinking  713. strange  714. eggs  715. wish  716. soil  717. human  718. trip  719. woman  720. eye  721. milk  722. choose  723. north  724. discovered  725. houses  726. seven  727. easily  728. famous  729. pages  730. late  731. rocks  732. flowers  733. pay  734. sleep  735. iron  736. trouble  737. store  738. beside  739. oil  740. modern  741. filled  742. fun  743. catch  744. growing  745. business  746. countries  747. helped  748. give  749. exactly  750. Jim  751. king  752. reach  753. lot  754. won't  755. answered  756. case  757. speak  758. shape  759. eight  760. edge  761. seems  762. soft  763. interesting  764. watched  765. formed  766. stories  767. village  768. object  769. stars  770. placed  771. Joe  772. age  773. minute  774. wall  775. b  776. meet  777. record  778. copy  779. forest  780. river  781. months  782. especially  783. dogs  784. necessary  785. lower  786. smaller  787. he's  788. unit  789. flat  790. 7  791. direction  792. south  793. subject  794. skin  795. wasn't  796. I've  797. Europe  798. NewYork  799. yellow  800. ships  801. forward  802. huge  803. needs  804. closed  805. ride  806. region  807. largest  808. answers  809. nor  810. period  811. finished  812. blood  813. rich  814. team  815. waves  816. corner  817. Mary  818. cat  819. amount  820. liked  821. garden  822. led  823. more  824. arms  825. party  826. force  827. test  828. bad  829. temperature  830. pair  831. ahead  832. wrong  833. practice  834. sand  835. tail  836. wait  837. difficult  838. general  839. cover  840. areas  841. material  842. talking  843. isn't  844. thousand  845. sign  846. examples  847. guess  848. begins  849. various  850. race  851. developed  852. bit  853. clothes  854. use  855. result  856. greater  857. fields  858. new  859. brother  860. addition  861. doesn't  862. states  863. dead  864. weight  865. thin  866. stone  867. hit  868. wife  869. played  870. island  871. standing  872. there's  873. we'll  874. opposite  875. born  876. sense  877. cattle  878. million  879. anyone  880. rule  881. science  882. helps  883. farmers  884. afraid  885. women  886. produce  887. pull  888. son  889. meant  890. broken  891. interest  892. ends  893. woods  894. Henry  895. chance  896. homes  897. thick  898. sight  899. pretty  900. 12  901. train  902. sets  903. fresh  904. faster  905. Washington  906. drive  907. lead  908. break  909. sit  910. bought  911. hundreds  912. radio  913. method  914. gets  915. king  916. similar  917. return  918. corn  919. decide  920. position  921. bear  922. hope  923. song  924. engine  925. missing  926. France  927. board  928. playing  929. control  930. spread  931. knows  932. evening  933. brown  934. picked  935. clean  936. wouldn't  937. section  938. spent  939. Dan  940. ring  941. higher  942. raised  943. 9  944. weeks  945. teeth  946. quiet  947. ancient  948. Jack  949. stick  950. afternoon  951. silver  952. nose  953. century  954. saying  955. therefore  956. flying  957. level  958. you'll  959. death  960. hole  961. coast  962. directions  963. cross  964. sharp  965. fight  966. capital  967. old  968. fill  969. deal  970. patterns  971. works  972. busy  973. pounds  974. beyond  975. seeds  976. Bob  977. produced  978. fingers  979. send  980. 100  981. love  982. materials  983. cool  984. laughed  985. cause  986. man's  987. stands  988. feeling  989. facts  990. please  991. meat  992. lady  993. west  994. glad  995. british  996. action  997. divided  998. greatest  999. happens  1000. pass  1001. 20  1002. returned  1003. adding  1004. ears  1005. soldiers  1006. type  1007. attention  1008. shouted  1009. gas  1010. world  1011. actually  1012. kitchen  1013. alike  1014. pick  1015. scale  1016. basic  1017. West  1018. president  1019. uncle  1020. Johnny  1021. happen  1022. walls  1023. Africa  1024. showed  1025. safe  1026. grown  1027. cost  1028. wear  1029. act  1030. wings  1031. Paul  1032. hat  1033. arm  1034. believe  1035. major  1036. becomes  1037. gray  1038. died  1039. bones  1040. sitting  1041. wonder  1042. include  1043. interested  1044. describe  1045. electric  1046. sold  1047. visit  1048. 15  1049. sheep  1050. I'd  1051. waiting  1052. shoes  1053. 30  1054. office  1055. contains  1056. row  1057. contain  1058. objects  1059. fit  1060. students  1061. turns  1062. clouds  1063. equal  1064. war  1065. value  1066. yard  1067. Americans  1068. beat  1069. inch  1070. walking  1071. sugar  1072. key  1073. product  1074. desert  1075. bank  1076. farther  1077. won  1078. total  1079. sell  1080. wire  1081. rose  1082. cotton  1083. moves  1084. spoke  1085. rope  1086. rules  1087. fear  1088. shore  1089. throughout  1090. compare  1091. Sam  1092. dollars  1093. x  1094. studied  1095. movement  1096. lands  1097. exercise  1098. tired  1099. bread  1100. streets  1101. process  1102. parents  1103. nature  1104. apart  1105. path  1106. careful  1107. simply  1108. Christmas  1109. narrow  1110. metal  1111. nine  1112. useful  1113. public  1114. buildings  1115. according  1116. steel  1117. salt  1118. carrying  1119. watching  1120. speech  1121. machines  1122. forth  1123. nation  1124. rivers  1125. knowledge  1126. appear  1127. insects  1128. ate  1129. dinner  1130. hurt  1131. Peter  1132. jumped  1133. spend  1134. experiment  1135. marks  1136. touch  1137. drop  1138. chair  1139. east  1140. dropped  1141. William  1142. separate  1143. truck  1144. sing  1145. elements  1146. column  1147. twice  1148. particular  1149. paragraph  1150. unless  1151. spot  1152. neither  1153. met  1154. workers  1155. father  1156. wheel  1157. continued  1158. none  1159. what's  1160. hill  1161. hills  1162. older  1163. television  1164. verb  1165. solve  1166. pressure  1167. report  1168. roots  1169. farmer  1170. count  1171. giving  1172. trade  1173. joined  1174. chief  1175. month  1176. F  1177. spanish  1178. term  1179. cloth  1180. D  1181. doctor  1182. indeed  1183. turning  1184. dance  1185. church  1186. original  1187. enjoy  1188. climbed  1189. string  1190. sea  1191. killed  1192. sister  1193. familiar  1194. hardly  1195. onto  1196. imagine  1197. blow  1198. quick  1199. law  1200. lie  1201. final  1202. rise  1203. certainly  1204. Billy  1205. loud  1206. fair  1207. pointed  1208. pushed  1209. herself  1210. learning  1211. slow  1212. noise  1213. marked  1214. statement  1215. hungry  1216. join  1217. find  1218. tube  1219. rode  1220. empty  1221. received  1222. Jane  1223. twenty  1224. broke  1225. nice  1226. effect  1227. paid  1228. motion  1229. myself  1230. talked  1231. divide  1232. wants  1233. supply  1234. laid  1235. crops  1236. millions  1237. cells  1238. dear  1239. 1/2  1240. surprise  1241. symbols  1242. boats  1243. gun  1244. units  1245. replied  1246. families  1247. entire  1248. fruit  1249. crowd  1250. tied  1251. band  1252. wet  1253. eating  1254. colors  1255. great  1256. solid  1257. besides  1258. northern  1259. noun  1260. star  1261. feed  1262. wooden  1263. sort  1264. lights  1265. greek  1266. red  1267. develop  1268. Dr.  1269. shoulder  1270. variety  1271. season  1272. news  1273. settled  1274. share  1275. closer  1276. jump  1277. regular  1278. changing  1279. represent  1280. opening  1281. market  1282. we're  1283. flew  1284. finger  1285. expect  1286. California  1287. army  1288. cabin  1289. camp  1290. schools  1291. 50  1292. danger  1293. purpose  1294. breakfast  1295. proper  1296. coat  1297. signs  1298. faces  1299. putting  1300. vowel  1301. fishing  1302. holding  1303. express  1304. shot  1305. instruments  1306. angry  1307. southern  1308. dress  1309. bag  1310. proud  1311. neck  1312. breath  1313. Mike  1314. strength  1315. described  1316. member  1317. twelve  1318. mine  1319. heads  1320. company  1321. current  1322. phrase  1323. valley  1324. directly  1325. double  1326. till  1327. differences  1328. match  1329. average  1330. related  1331. die  1332. figures  1333. liquid  1334. caused  1335. alive  1336. bodies  1337. games  1338. considered  1339. stream  1340. provide  1341. drink  1342. starting  1343. reasons  1344. experience  1345. future  1346. tomorrow  1347. drove  1348. population  1349. finish  1350. station  1351. completely  1352. arrived  1353. shook  1354. stage  1355. oxygen  1356. poem  1357. solution  1358. branches  1359. roads  1360. Mexico  1361. degrees  1362. coal  1363. cent  1364. conditions  1365. electricity  1366. 25  1367. everybody  1368. drawing  1369. rare  1370. dust  1371. worth  1372. follows  1373. scientific  1374. exciting  1375. community  1376. captain  1377. bus  1378. protect  1379. compound  1380. brothers  1381. winds  1382. raise  1383. further  1384. yards  1385. guide  1386. quietly  1387. discover  1388. east  1389. plain  1390. correctly  1391. smiled  1392. keeping  1393. steam  1394. usual  1395. showing  1396. telling  1397. easier  1398. scar  1399. range  1400. appeared  1401. root  1402. consider  1403. wagon  1404. baseball  1405. rubber  1406. surprised  1407. hunting  1408. symbol  1409. seeing  1410. Chinese  1411. Pacific  1412. support  1413. leg  1414. windows  1415. Texas  1416. industry  1417. mile  1418. forests  1419. beneath  1420. likely  1421. win  1422. fence  1423. maps  1424. believed  1425. islands  1426. noticed  1427. runs  1428. centuries  1429. popular  1430. stayed  1431. chart  1432. Ann  1433. master  1434. lake  1435. falls  1436. d  1437. sheet  1438. explained  1439. notes  1440. mass  1441. art  1442. bottle  1443. desk  1444. colored  1445. nest  1446. storm  1447. everywhere  1448. clearly  1449. development  1450. closely  1451. fourth  1452. push  1453. earth  1454. rolled  1455. flight  1456. smoke  1457. upper  1458. remembered  1459. track  1460. mixed  1461. forget  1462. bigger  1463. nearby  1464. plenty  1465. based  1466. leaving  1467. save  1468. belong  1469. laws  1470. structure  1471. height  1472. suggested  1473. German  1474. observe  1475. located  1476. clock  1477. giant  1478. captain  1479. smell  1480. planes  1481. railroad  1482. knife  1483. grows  1484. I  1485. results  1486. spelling  1487. friendly  1488. flow  1489. plans  1490. whatever  1491. barn  1492. beauty  1493. bell  1494. wonderful  1495. rapidly  1496. little  1497. tone  1498. agreed  1499. wore  1500. ending  1501. tools  1502. pairs  1503. goods  1504. fifty  1505. nearest  1506. wave  1507. m  1508. sweet  1509. deer  1510. threw  1511. dangerous  1512. clothing  1513. events  1514. leader  1515. waters  1516. Atlantic  1517. lunch  1518. boxes  1519. mud  1520. generally  1521. hung  1522. ear  1523. peace  1524. spell  1525. golden  1526. wheat  1527. chapter  1528. immediately  1529. gathered  1530. favorite  1531. understanding  1532. apple  1533. 0  1534. expected  1535. sad  1536. plate  1537. score  1538. smooth  1539. traveled  1540. each  1541. service  1542. cows  1543. sail  1544. grain  1545. driver  1546. forces  1547. white  1548. telephone  1549. singing  1550. farms  1551. instance  1552. swim  1553. powerful  1554. drew  1555. foods  1556. bar  1557. egg  1558. Italy  1559. cases  1560. meeting  1561. shop  1562. Germany  1563. bowl  1564. newspaper  1565. fat  1566. view  1567. cry  1568. dressed  1569. source  1570. hurry  1571. wheels  1572. latin  1573. nobody  1574. James  1575. details  1576. dad  1577. muscles  1578. model  1579. climate  1580. coffee  1581. lifted  1582. lies  1583. whenever  1584. whom  1585. silent  1586. flower  1587. broad  1588. serious  1589. continue  1590. airplane  1591. supper  1592. methods  1593. trail  1594. atmosphere  1595. western  1596. persons  1597. handle  1598. angle  1599. throw  1600. allowed  1601. keeps  1602. drawn  1603. leading  1604. feathers  1605. waited  1606. China  1607. you've  1608. funny  1609. dictionary  1610. scientist  1611. taught  1612. climb  1613. fighting  1614. ordinary  1615. series  1616. towns  1617. burning  1618. types  1619. extra  1620. rough  1621. Roman  1622. vast  1623. 18  1624. serve  1625. riding  1626. library  1627. helping  1628. program  1629. magic  1630. earlier  1631. manner  1632. softly  1633. chemical  1634. suit  1635. pencil  1636. e  1637. tongue  1638. eye  1639. loved  1640. struck  1641. freedom  1642. they're  1643. remain  1644. planets  1645. settlers  1646. smaller  1647. title  1648. Oh  1649. plays  1650. fellow  1651. cents  1652. enemy  1653. cloud  1654. roof  1655. student  1656. laugh  1657. kill  1658. including  1659. swimming  1660. direct  1661. pleasant  1662. charge  1663. mama  1664. lose  1665. individual  1666. roll  1667. listed  1668. growth  1669. national  1670. speaking  1671. regions  1672. style  1673. political  1674. he'd  1675. ordered  1676. prepared  1677. daughter  1678. plains  1679. studying  1680. hall  1681. education  1682. highest  1683. may  1684. vegetables  1685. signal  1686. cup  1687. indicate  1688. Japanese  1689. 11  1690. design  1691. secret  1692. copper  1693. Frank  1694. stones  1695. blocks  1696. block  1697. equipment  1698. skill  1699. lift  1700. lying  1701. perfect  1702. wash  1703. nations  1704. verbs  1705. cow  1706. printed  1707. agree  1708. sunlight  1709. smile  1710. expression  1711. bow  1712. shut  1713. shining  1714. particularly  1715. thank  1716. planet  1717. property  1718. brain  1719. bridge  1720. asleep  1721. taste  1722. starts  1723. European  1724. price  1725. scene  1726. planned  1727. St.  1728. factors  1729. includes  1730. battle  1731. health  1732. sleeping  1733. fought  1734. cave  1735. Ben  1736. composition  1737. 40  1738. fur  1739. pocket  1740. prove  1741. holes  1742. y  1743. knowing  1744. police  1745. social  1746. 24  1747. factories  1748. Mark  1749. Asia  1750. dishes  1751. discuss  1752. post  1753. enter  1754. 14  1755. traveling  1756. crossed  1757. n  1758. local  1759. park  1760. brave  1761. burned  1762. stretched  1763. ants  1764. shoulders  1765. escape  1766. mostly  1767. division  1768. measures  1769. clay  1770. sailed  1771. valuable  1772. potatoes  1773. tip  1774. weak  1775. lion  1776. poles  1777. sir  1778. Congress  1779. lovely  1780. eaten  1781. ability  1782. balance  1783. success  1784. search  1785. sticks  1786. crew  1787. voices  1788. determine  1789. excited  1790. parallel  1791. represents  1792. nouns  1793. attack  1794. hunt  1795. bat  1796. increase  1797. Lake  1798. appears  1799. apples  1800. neighbors  1801. activities  1802. Lincoln  1803. subjects  1804. Paris  1805. outer  1806. volume  1807. sick  1808. whale  1809. earth's  1810. successful  1811. invented  1812. falling  1813. wished  1814. entered  1815. 13  1816. excitement  1817. quarter  1818. log  1819. songs  1820. cake  1821. unusual  1822. personal  1823. gate  1824. jar  1825. cream  1826. wearing  1827. London  1828. bone  1829. phrases  1830. wise  1831. birthday  1832. papers  1833. candy  1834. o'clock  1835. flag  1836. strike  1837. gently  1838. traffic  1839. sum  1840. Sally  1841. minerals  1842. streams  1843. article  1844. hide  1845. recognize  1846. recent  1847. frequently  1848. central  1849. shell  1850. 16  1851. court  1852. driving  1853. gradually  1854. remained  1855. India  1856. automobile  1857. safety  1858. eastern  1859. Boston  1860. p  1861. hurried  1862. meanings  1863. arranged  1864. tie  1865. darkness  1866. branch  1867. Ocean  1868. S  1869. fifteen  1870. hadn't  1871. proved  1872. pond  1873. holds  1874. terrible  1875. jobs  1876. frightened  1877. forced  1878. Spain  1879. shells  1880. function  1881. impossible  1882. slightly  1883. somewhat  1884. U  1885. steady  1886. Papa  1887. 200  1888. rows  1889. listened  1890. sang  1891. Robert  1892. Western  1893. wondered  1894. Canada  1895. passing  1896. frame  1897. element  1898. diagram  1899. washed  1900. aren't  1901. character  1902. setting  1903. instrument  1904. message  1905. Street  1906. club  1907. cell  1908. records  1909. chosen  1910. laughing  1911. world's  1912. pie  1913. appearance  1914. Aunt  1915. repeated  1916. causes  1917. situation  1918. rhythm  1919. supplies  1920. thoughts  1921. lakes  1922. stepped  1923. loose  1924. increase  1925. lips  1926. exact  1927. yesterday  1928. E  1929. depends  1930. angles  1931. factory  1932. Charles  1933. spirit  1934. rays  1935. avoid  1936. provided  1937. player  1938. surely  1939. sorry  1940. cutting  1941. father's  1942. importance  1943. progress  1944. paint  1945. seconds  1946. Richard  1947. journey  1948. 500  1949. doubt  1950. sections  1951. Dick  1952. lots  1953. statements  1954. ruler  1955. likes  1956. dozen  1957. served  1958. doors  1959. basket  1960. thinks  1961. established  1962. quality  1963. deck  1964. indicated  1965. effort  1966. dream  1967. pipe  1968. harder  1969. Alaska  1970. pulling  1971. flies  1972. lesson  1973. ended  1974. calls  1975. dancing  1976. spelled  1977. Italian  1978. chickens  1979. engines  1980. rod  1981. football  1982. rooms  1983. physical  1984. identify  1985. cage  1986. experiments  1987. Tommy  1988. drops  1989. daily  1990. included  1991. cook  1992. containing  1993. players  1994. sudden  1995. disappeared  1996. pole  1997. particles  1998. joy  1999. replace  2000. foreign  2001. you'd  2002. fuel  2003. realize  2004. Chicago  2005. card  2006. bill  2007. bent  2008. haven't  2009. hidden  2010. carbon  2011. thirty  2012. Japan  2013. allow  2014. Union  2015. greatly  2016. rocket  2017. term  2018. cap  2019. sounded  2020. listening  2021. jet  2022. calling  2023. thread  2024. Brown  2025. created  2026. merely  2027. represented  2028. Grandfather  2029. butter  2030. dried  2031. Thomas  2032. visited  2033. March  2034. chest  2035. molecules  2036. feelings  2037. Negro  2038. Saturday  2039. shade  2040. planted  2041. continent  2042. pink  2043. crowded  2044. rice  2045. Dutch  2046. somewhere  2047. courage  2048. hunters  2049. chicken  2050. occur  2051. shadow  2052. truth  2053. due  2054. native  2055. load  2056. orange  2057. rolling  2058. General  2059. begun  2060. offered  2061. training  2062. pitch  2063. account  2064. discovery  2065. creatures  2066. honor  2067. removed  2068. passes  2069. Sir  2070. blank  2071. shirt  2072. gather  2073. suggest  2074. ranch  2075. required  2076. Black  2077. prevent  2078. tight  2079. House  2080. queen  2081. enjoyed  2082. leaf  2083. tin  2084. meal  2085. available  2086. rising  2087. ought  2088. whispered  2089. National  2090. Louis  2091. straw  2092. attached  2093. wool  2094. duck  2095. tear  2096. separated  2097. cats  2098. date  2099. layers  2100. bark  2101. college  2102. safely  2103. furniture  2104. leather  2105. moon  2106. determined  2107. exercises  2108. entirely  2109. 17  2110. factor  2111. silence  2112. combined  2113. remains  2114. standard  2115. saved  2116. recently  2117. tracks  2118. hanging  2119. City  2120. teach  2121. involved  2122. biggest  2123. gentle  2124. strip  2125. pack  2126. bare  2127. classroom  2128. press  2129. sailors  2130. chain  2131. bits  2132. rabbit  2133. shaped  2134. breathing  2135. helpful  2136. newspapers  2137. pound  2138. pure  2139. forget  2140. musical  2141. 60  2142. layer  2143. substance  2144. choice  2145. prepare  2146. fixed  2147. environment  2148. Jimmy  2149. highly  2150. Valley  2151. spoken  2152. Sunday  2153. oceans  2154. disease  2155. banks  2156. depend  2157. sailing  2158. shorter  2159. snake  2160. balloon  2161. exclaimed  2162. cheese  2163. forgotten  2164. husband  2165. partly  2166. atoms  2167. blew  2168. dollar  2169. worn  2170. shoot  2171. slipped  2172. medicine  2173. measured  2174. receive  2175. produces  2176. frozen  2177. throat  2178. supposed  2179. pool  2180. trucks  2181. condition  2182. cowboy  2183. lonely  2184. belongs  2185. pine  2186. consists  2187. citizens  2188. Smith  2189. conversation  2190. collection  2191. differ  2192. circus  2193. audience  2194. triangle  2195. globe  2196. mice  2197. Big  2198. anywhere  2199. fog  2200. pet  2201. influence  2202. we've  2203. African  2204. June  2205. logs  2206. aid  2207. pile  2208. July  2209. worry  2210. 1/4  2211. she's  2212. tonight  2213. bushes  2214. hoped  2215. complex  2216. construction  2217. author  2218. Queen  2219. task  2220. underline  2221. Day  2222. research  2223. basis  2224. principal  2225. graph  2226. elephant  2227. improve  2228. fruits  2229. oldest  2230. mouse  2231. Virginia  2232. arrow  2233. stores  2234. organized  2235. colonies  2236. carries  2237. evidence  2238. Mississippi  2239. studies  2240. degree  2241. production  2242. motor  2243. numerals  2244. piano  2245. handed  2246. bears  2247. pan  2248. theory  2249. swing  2250. painted  2251. knees  2252. mirror  2253. pony  2254. dirt  2255. miss  2256. thee  2257. o  2258. route  2259. slide  2260. couple  2261. N  2262. mother's  2263. create  2264. silk  2265. burst  2266. curious  2267. mighty  2268. examine  2269. combine  2270. operation  2271. understood  2272. realize  2273. respect  2274. fed  2275. owned  2276. uncle  2277. touched  2278. rights  2279. concerned  2280. covers  2281. distant  2282. refer  2283. lack  2284. Betsy  2285. anyway  2286. babies  2287. hearing  2288. failed  2289. 300  2290. shapes  2291. tea  2292. reaches  2293. mail  2294. stronger  2295. poured  2296. rushed  2297. edges  2298. highway  2299. periods  2300. numbers  2301. repeat  2302. Andy  2303. collect  2304. struck  2305. pen  2306. pictured  2307. excellent  2308. blanket  2309. aside  2310. dig  2311. enemies  2312. planning  2313. pain  2314. needle  2315. missed  2316. nodded  2317. connected  2318. beans  2319. cards  2320. upward  2321. gain  2322. offer  2323. Wheels  2324. expressed  2325. combination  2326. spaces  2327. unknown  2328. luck  2329. movements  2330. languages  2331. brush  2332. balls  2333. fastened  2334. seas  2335. Island  2336. completed  2337. systems  2338. features  2339. observed  2340. Pa  2341. Greeks  2342. stretch  2343. composed  2344. wherever  2345. willing  2346. married  2347. fallen  2348. landed  2349. amounts  2350. religious  2351. fits  2352. sheets  2353. orbit  2354. review  2355. youth  2356. bars  2357. wires  2358. resources  2359. designed  2360. tax  2361. waste  2362. Edward  2363. tower  2364. lamp  2365. president  2366. comfortable  2367. sees  2368. tent  2369. becoming  2370. atomic  2371. topic  2372. flows  2373. locate  2374. pleased  2375. leader  2376. crop  2377. burn  2378. outline  2379. feels  2380. trick  2381. transportation  2382. bicycle  2383. villages  2384. thrown  2385. buffalo  2386. signals  2387. pigs  2388. aloud  2389. Carlos  2390. dots  2391. spite  2392. counting  2393. slept  2394. landing  2395. trained  2396. grandfather  2397. blowing  2398. etc.  2399. worse  2400. boy's  2401. middle  2402. accident  2403. younger  2404. judge  2405. stove  2406. valleys  2407. gasoline  2408. castle  2409. spider  2410. normal  2411. steep  2412. tough  2413. active  2414. tops  2415. affect  2416. bound  2417. driven  2418. trunk  2419. visitors  2420. military  2421. society  2422. stared  2423. fairly  2424. obtain  2425. mountains  2426. reader  2427. additional  2428. boy  2429. machinery  2430. recognized  2431. plus  2432. hollow  2433. explore  2434. travels  2435. tables  2436. bite  2437. unlike  2438. stairs  2439. scattered  2440. Wilson  2441. percent  2442. earn  2443. hang  2444. State  2445. items  2446. arrange  2447. loss  2448. sisters  2449. raw  2450. TV  2451. skins  2452. boots  2453. Don  2454. belt  2455. he'll  2456. salmon  2457. aware  2458. 400  2459. pleasure  2460. stored  2461. origin  2462. perform  2463. tank  2464. plural  2465. weight  2466. adjective  2467. gods  2468. event  2469. Columbus  2470. eventually  2471. zero  2472. bringing  2473. remove  2474. yours  2475. trains  2476. neighbor  2477. alphabet  2478. rises  2479. tribes  2480. covering  2481. stomach  2482. select  2483. characteristics  2484. enormous  2485. industrial  2486. Australia  2487. bells  2488. fifth  2489. loaded  2490. companies  2491. poet  2492. screen  2493. consonant  2494. pushing  2495. Jones  2496. mistake  2497. arrows  2498. stranger  2499. acts  2500. thanks  2501. specific  2502. toes  2503. mood  2504. negative  2505. principles  2506. income  2507. primitive  2508. airplanes  2509. false  2510. accepted  2511. sports  2512. September  2513. blind  2514. accept  2515. today's  2516. orders  2517. universe  2518. tribe  2519. headed  2520. passage  2521. obtained  2522. surrounded  2523. classes  2524. somebody  2525. compass  2526. measuring  2527. substances  2528. values  2529. seldom  2530. thou  2531. remaining  2532. 21  2533. lucky  2534. anybody  2535. April  2536. naturally  2537. automobiles  2538. owner  2539. grade  2540. rings  2541. purple  2542. seed  2543. swam  2544. guns  2545. rounded  2546. rabbits  2547. syllables  2548. magnet  2549. prize  2550. raced  2551. T  2552. colony  2553. announced  2554. dug  2555. numeral  2556. compared  2557. curve  2558. distances  2559. Johnson  2560. perfectly  2561. Man  2562. pilot  2563. Tim  2564. struggle  2565. herd  2566. Eddie  2567. previous  2568. Florida  2569. pot  2570. definition  2571. tape  2572. porch  2573. vote  2574. mad  2575. waved  2576. powder  2577. trace  2578. Alice  2579. gift  2580. tightly  2581. sizes  2582. tests  2583. bees  2584. happening  2585. badly  2586. fewer  2587. industries  2588. nights  2589. introduced  2590. nails  2591. insect  2592. halfway  2593. syllable  2594. principle  2595. activity  2596. Central  2597. temperatures  2598. creature  2599. Mars  2600. dish  2601. David  2602. handsome  2603. mainly  2604. teachers  2605. pupils  2606. breathe  2607. swept  2608. racing  2609. trips  2610. firmly  2611. Greece  2612. hay  2613. packed  2614. vertical  2615. package  2616. harbor  2617. reports  2618. r  2619. behavior  2620. writer  2621. apartment  2622. pale  2623. destroyed  2624. diameter  2625. articles  2626. settle  2627. indicates  2628. mentioned  2629. collected  2630. positions  2631. actual  2632. worried  2633. somehow  2634. saddle  2635. wound  2636. stock  2637. officer  2638. typical  2639. engineer  2640. welcome  2641. duty  2642. dot  2643. snakes  2644. fix  2645. fox  2646. refused  2647. port  2648. bend  2649. drawings  2650. tropical  2651. Gulf  2652. stems  2653. eager  2654. guard  2655. widely  2656. frog  2657. Russia  2658. forty  2659. flame  2660. canoe  2661. teams  2662. organization  2663. atom  2664. tide  2665. wrapped  2666. skills  2667. wing  2668. gained  2669. slabs  2670. cooking  2671. torn  2672. properties  2673. horn  2674. cowboys  2675. effects  2676. split  2677. Fred  2678. former  2679. yelled  2680. invention  2681. unhappy  2682. limited  2683. movie  2684. Rome  2685. Prince  2686. presented  2687. ill  2688. Southern  2689. shoe  2690. puts  2691. command  2692. Bay  2693. managed  2694. mental  2695. difficulty  2696. roar  2697. nearer  2698. messages  2699. adventure  2700. Ohio  2701. birth  2702. circles  2703. ducks  2704. buried  2705. hello  2706. declared  2707. weren't  2708. strips  2709. rear  2710. performed  2711. crack  2712. protection  2713. brings  2714. Maria  2715. private  2716. goose  2717. elephants  2718. Russian  2719. squares  2720. interior  2721. chamber  2722. jungle  2723. replaced  2724. belonged  2725. dirty  2726. noted  2727. applied  2728. scales  2729. 35  2730. nervous  2731. dull  2732. brass  2733. opportunity  2734. hospital  2735. occurs  2736. sources  2737. guests  2738. invited  2739. seats  2740. plastic  2741. tons  2742. contained  2743. definite  2744. prime  2745. location  2746. eleven  2747. curved  2748. October  2749. aboard  2750. troops  2751. captured  2752. spots  2753. sink  2754. voyage  2755. shelf  2756. ore  2757. washing  2758. firm  2759. accurate  2760. equally  2761. Pole  2762. crossing  2763. Daniel  2764. mixture  2765. Jeff  2766. checked  2767. shelter  2768. pasture  2769. constant  2770. soldier  2771. shine  2772. victory  2773. whistle  2774. slave  2775. breaking  2776. dawn  2777. farming  2778. services  2779. equator  2780. thy  2781. camera  2782. opinion  2783. characters  2784. fully  2785. lighted  2786. experiences  2787. counted  2788. pour  2789. labor  2790. brief  2791. properly  2792. pointing  2793. horns  2794. appropriate  2795. corners  2796. 90  2797. arrive  2798. gravity  2799. fierce  2800. bet  2801. independence  2802. cleared  2803. label  2804. cast  2805. positive  2806. occasionally  2807. melted  2808. peoples  2809. crying  2810. attempt  2811. fires  2812. f  2813. require  2814. sale  2815. thumb  2816. tubes  2817. wagons  2818. A**  2819. Danny  2820. fort  2821. film  2822. passengers  2823. tossed  2824. advice  2825. arithmetic  2826. January  2827. donkey  2828. discussion  2829. shake  2830. lessons  2831. memory  2832. garage  2833. glasses  2834. pride  2835. charged  2836. finds  2837. policeman  2838. University  2839. School  2840. palace  2841. relationship  2842. slip  2843. Mountain  2844. selection  2845. satellites  2846. New York City  2847. lowest  2848. doll  2849. satisfied  2850. Norway  2851. toy  2852. hats  2853. habits  2854. arrangement  2855. promised  2856. calm  2857. Mount  2858. Martin  2859. rocky  2860. neighborhood  2861. warning  2862. Harry  2863. kids  2864. cookies  2865. metals  2866. monkey  2867. vapor  2868. grabbed  2869. deeply  2870. currents  2871. doctors  2872. originally  2873. walks  2874. happily  2875. chairs  2876. floating  2877. powers  2878. adjectives  2879. poetry  2880. slope  2881. bags  2882. Star  2883. species  2884. lengths  2885. nuts  2886. remarkable  2887. August  2888. acres  2889. tricks  2890. essential  2891. constantly  2892. depth  2893. requires  2894. mineral  2895. canal  2896. coach  2897. dreams  2898. M  2899. complicated  2900. Lee  2901. Casey  2902. swung  2903. exchange  2904. hunter  2905. exist  2906. reported  2907. tune  2908. shallow  2909. image  2910. tobacco  2911. stiff  2912. increasing  2913. precious  2914. presents  2915. damage  2916. treated  2917. folks  2918. Illinois  2919. adult  2920. spin  2921. shed  2922. Philadelphia  2923. grandmother  2924. customs  2925. mathematics  2926. heated  2927. claws  2928. reaching  2929. official  2930. recall  2931. explanation  2932. developing  2933. mysterious  2934. recorded  2935. shout  2936. practical  2937. Pennsylvania  2938. t  2939. P  2940. 70  2941. V  2942. plates  2943. officers  2944. wolf  2945. raising  2946. deeper  2947. wishes  2948. instant  2949. writers  2950. scared  2951. breeze  2952. contrast  2953. Egypt  2954. X  2955. mission  2956. tales  2957. vessels  2958. silly  2959. border  2960. G  2961. trap  2962. zoo  2963. occurred  2964. wealth  2965. manufacturing  2966. Hill  2967. fired  2968. mill  2969. heading  2970. Ellen  2971. rubbed  2972. brick  2973. tremendous  2974. compounds  2975. 23  2976. chose  2977. simplest  2978. slight  2979. solar  2980. grains  2981. stated  2982. drinking  2983. fireplace  2984. stops  2985. shaking  2986. goal  2987. rhyme  2988. 45  2989. 80  2990. facing  2991. autumn  2992. possibly  2993. habit  2994. shooting  2995. ourselves  2996. centers  2997. rush  2998. soap  2999. finest  3000. lungs